"Fecha","localidad","Confirmados","Descartados","En estudio","Notificaciones"
"2020-03-24","ARMSTRONG","0","1","0","1"
"2020-03-24","ARROYO LEYES","0","0","1","1"
"2020-03-24","CAPITAN BERMUDEZ","0","1","0","1"
"2020-03-24","CARMEN","0","0","1","1"
"2020-03-24","CASILDA","0","0","1","1"
"2020-03-24","CERES","0","0","1","1"
"2020-03-24","ESPERANZA","1","1","0","2"
"2020-03-24","FIRMAT","0","0","1","1"
"2020-03-24","FLORENCIA","0","1","0","1"
"2020-03-24","FRANCK","0","1","0","1"
"2020-03-24","FUNES","0","1","1","2"
"2020-03-24","GALVEZ","2","0","5","7"
"2020-03-24","GRANADERO BAIGORRIA","0","2","0","2"
"2020-03-24","HELVECIA","2","0","1","3"
"2020-03-24","HUMBOLDT","0","0","1","1"
"2020-03-24","JOSEFINA","0","1","0","1"
"2020-03-24","LAS PAREJAS","0","0","1","1"
"2020-03-24","MONTE VERA","0","0","1","1"
"2020-03-24","PUEBLO ESTHER","0","2","0","2"
"2020-03-24","RAFAELA","3","2","2","7"
"2020-03-24","RECONQUISTA","0","1","0","1"
"2020-03-24","RECREO","0","2","0","2"
"2020-03-24","ROLDAN","2","0","0","2"
"2020-03-24","ROSARIO","8","49","20","77"
"2020-03-24","RUFINO","0","0","1","1"
"2020-03-24","SAN GENARO","0","0","1","1"
"2020-03-24","SAN JAVIER","0","2","1","3"
"2020-03-24","SAN LORENZO","0","2","1","3"
"2020-03-24","SANTA FE","1","14","20","35"
"2020-03-24","SANTO TOME","0","2","3","5"
"2020-03-24","SASTRE","0","1","0","1"
"2020-03-24","SAUCE VIEJO","0","0","1","1"
"2020-03-24","TACURAL","0","1","0","1"
"2020-03-24","TIMBUES","0","1","0","1"
"2020-03-24","VENADO TUERTO","0","3","2","5"
"2020-03-24","VILLA CONSTITUCION","0","2","2","4"
"2020-03-24","VILLA GOBERNADOR GALVEZ","1","2","0","3"
"2020-03-24","VILLA MUGUETA","0","0","1","1"
"2020-03-25","ALVAREZ","0","1","0","1"
"2020-03-25","ANGEL GALLARDO","0","0","1","1"
"2020-03-25","ARMSTRONG","0","1","0","1"
"2020-03-25","ARROYO LEYES","0","1","0","1"
"2020-03-25","AVELLANEDA","0","0","1","1"
"2020-03-25","CAMPO LA PEPITA","0","0","1","1"
"2020-03-25","CAÑADA DE GOMEZ","0","1","0","1"
"2020-03-25","CAPITAN BERMUDEZ","0","1","2","3"
"2020-03-25","CARMEN","0","0","1","1"
"2020-03-25","CARRERAS","0","0","1","1"
"2020-03-25","CASILDA","1","0","0","1"
"2020-03-25","CERES","0","0","1","1"
"2020-03-25","ESPERANZA","1","1","1","3"
"2020-03-25","FIRMAT","0","0","1","1"
"2020-03-25","FLORENCIA","0","1","0","1"
"2020-03-25","FRANCK","0","1","1","2"
"2020-03-25","GALVEZ","3","1","3","7"
"2020-03-25","GRANADERO BAIGORRIA","0","3","0","3"
"2020-03-25","HELVECIA","2","0","5","7"
"2020-03-25","HUMBOLDT","0","0","1","1"
"2020-03-25","JOSEFINA","0","1","0","1"
"2020-03-25","LAS PAREJAS","0","0","1","1"
"2020-03-25","MONTE VERA","0","1","0","1"
"2020-03-25","PEREZ","0","1","0","1"
"2020-03-25","PUEBLO ESTHER","0","2","0","2"
"2020-03-25","PUERTO GENERAL SAN MARTIN","0","0","2","2"
"2020-03-25","RAFAELA","4","1","1","6"
"2020-03-25","RECONQUISTA","0","1","3","4"
"2020-03-25","RECREO","0","3","1","4"
"2020-03-25","ROLDAN","2","0","0","2"
"2020-03-25","ROSARIO","10","57","23","90"
"2020-03-25","RUFINO","0","1","0","1"
"2020-03-25","SAN GENARO","0","0","1","1"
"2020-03-25","SAN JAVIER","1","2","0","3"
"2020-03-25","SAN JORGE","0","0","1","1"
"2020-03-25","SAN JOSE DEL RINCON","0","0","2","2"
"2020-03-25","SAN LORENZO","0","2","2","4"
"2020-03-25","SANTA FE","8","21","10","39"
"2020-03-25","SANTO TOME","3","3","0","6"
"2020-03-25","SASTRE","0","1","0","1"
"2020-03-25","SAUCE VIEJO","1","0","1","2"
"2020-03-25","SUNCHALES","0","1","0","1"
"2020-03-25","TACURAL","0","1","0","1"
"2020-03-25","VENADO TUERTO","1","3","1","5"
"2020-03-25","VERA","0","0","1","1"
"2020-03-25","VILLA CONSTITUCION","1","3","1","5"
"2020-03-25","VILLA GOBERNADOR GALVEZ","1","2","1","4"
"2020-03-25","VILLA MUGUETA","0","1","0","1"
"2020-03-26","ALVAREZ","0","1","0","1"
"2020-03-26","ANGEL GALLARDO","0","0","1","1"
"2020-03-26","ARMSTRONG","0","1","0","1"
"2020-03-26","AROCENA","0","0","2","2"
"2020-03-26","ARROYO LEYES","0","1","1","2"
"2020-03-26","AVELLANEDA","0","0","1","1"
"2020-03-26","CAÑADA DE GOMEZ","0","1","0","1"
"2020-03-26","CAPITAN BERMUDEZ","0","1","2","3"
"2020-03-26","CARLOS PELLEGRINI","0","1","0","1"
"2020-03-26","CARMEN","0","0","1","1"
"2020-03-26","CARRERAS","0","1","0","1"
"2020-03-26","CASILDA","2","0","1","3"
"2020-03-26","CAYASTA","0","0","1","1"
"2020-03-26","CERES","0","1","0","1"
"2020-03-26","ESPERANZA","1","1","2","4"
"2020-03-26","FIRMAT","0","0","1","1"
"2020-03-26","FLORENCIA","0","1","0","1"
"2020-03-26","FRANCK","1","1","0","2"
"2020-03-26","FUNES","0","0","2","2"
"2020-03-26","GALVEZ","3","4","2","9"
"2020-03-26","GRANADERO BAIGORRIA","0","3","1","4"
"2020-03-26","HELVECIA","2","2","4","8"
"2020-03-26","HUMBOLDT","1","0","0","1"
"2020-03-26","JOSEFINA","0","1","0","1"
"2020-03-26","LAS PAREJAS","1","0","0","1"
"2020-03-26","MACIEL","0","0","1","1"
"2020-03-26","MONTE VERA","0","1","0","1"
"2020-03-26","PEREZ","0","1","0","1"
"2020-03-26","PUEBLO ESTHER","0","2","0","2"
"2020-03-26","PUERTO GENERAL SAN MARTIN","0","1","1","2"
"2020-03-26","RAFAELA","5","1","9","15"
"2020-03-26","RECONQUISTA","0","1","4","5"
"2020-03-26","RECREO","0","3","1","4"
"2020-03-26","ROLDAN","2","0","1","3"
"2020-03-26","ROSARIO","14","78","18","110"
"2020-03-26","RUFINO","0","1","0","1"
"2020-03-26","SAN CARLOS CENTRO","0","0","1","1"
"2020-03-26","SAN GENARO","0","0","1","1"
"2020-03-26","SAN JAVIER","1","2","0","3"
"2020-03-26","SAN JORGE","0","1","0","1"
"2020-03-26","SAN JOSE DEL RINCON","1","1","0","2"
"2020-03-26","SAN JUSTO","0","0","2","2"
"2020-03-26","SAN LORENZO","0","2","2","4"
"2020-03-26","SANTA FE","13","28","16","57"
"2020-03-26","SANTO TOME","3","3","3","9"
"2020-03-26","SASTRE","0","1","0","1"
"2020-03-26","SAUCE VIEJO","1","1","0","2"
"2020-03-26","SUARDI","0","0","1","1"
"2020-03-26","SUNCHALES","0","1","1","2"
"2020-03-26","TACURAL","0","1","1","2"
"2020-03-26","VENADO TUERTO","1","3","2","6"
"2020-03-26","VERA","1","0","0","1"
"2020-03-26","VILLA CONSTITUCION","1","3","1","5"
"2020-03-26","VILLA GOBERNADOR GALVEZ","1","3","1","5"
"2020-03-26","VILLA MUGUETA","0","1","0","1"
"2020-03-27","ALVAREZ","0","1","0","1"
"2020-03-27","ANGEL GALLARDO","0","1","0","1"
"2020-03-27","ARMSTRONG","0","1","0","1"
"2020-03-27","AROCENA","0","0","2","2"
"2020-03-27","ARROYO LEYES","0","1","1","2"
"2020-03-27","ARROYO SECO","0","1","0","1"
"2020-03-27","AVELLANEDA","0","0","1","1"
"2020-03-27","CAÑADA DE GOMEZ","0","1","1","2"
"2020-03-27","CAPITAN BERMUDEZ","0","1","2","3"
"2020-03-27","CARCARAÑA","0","0","1","1"
"2020-03-27","CARLOS PELLEGRINI","0","1","0","1"
"2020-03-27","CARMEN","0","1","0","1"
"2020-03-27","CARRERAS","0","1","0","1"
"2020-03-27","CASILDA","2","0","3","5"
"2020-03-27","CAYASTA","0","0","1","1"
"2020-03-27","CERES","0","1","0","1"
"2020-03-27","CHABAS","0","1","1","2"
"2020-03-27","CORONDA","0","0","1","1"
"2020-03-27","CORONEL RODOLFO S. DOMINGUEZ","0","0","1","1"
"2020-03-27","ESPERANZA","1","1","3","5"
"2020-03-27","FIRMAT","0","1","0","1"
"2020-03-27","FLORENCIA","0","1","0","1"
"2020-03-27","FRANCK","1","1","2","4"
"2020-03-27","FUNES","0","1","1","2"
"2020-03-27","GABOTO","0","1","0","1"
"2020-03-27","GALVEZ","3","4","2","9"
"2020-03-27","GESSLER","0","0","1","1"
"2020-03-27","GRANADERO BAIGORRIA","0","4","0","4"
"2020-03-27","HELVECIA","2","2","4","8"
"2020-03-27","HUMBOLDT","1","0","0","1"
"2020-03-27","JOSEFINA","0","1","0","1"
"2020-03-27","LAS PAREJAS","1","0","0","1"
"2020-03-27","MACIEL","0","0","1","1"
"2020-03-27","MONTE VERA","0","1","0","1"
"2020-03-27","PEREZ","0","1","0","1"
"2020-03-27","PUEBLO ANDINO","1","0","0","1"
"2020-03-27","PUEBLO ESTHER","0","2","0","2"
"2020-03-27","PUERTO GENERAL SAN MARTIN","0","1","1","2"
"2020-03-27","PUERTO RECONQUISTA","0","0","1","1"
"2020-03-27","RAFAELA","5","1","10","16"
"2020-03-27","RECONQUISTA","0","1","8","9"
"2020-03-27","RECREO","0","4","0","4"
"2020-03-27","ROLDAN","2","0","2","4"
"2020-03-27","ROSARIO","20","110","19","149"
"2020-03-27","RUFINO","0","1","0","1"
"2020-03-27","SAN CARLOS CENTRO","0","0","3","3"
"2020-03-27","SAN GENARO","0","1","0","1"
"2020-03-27","SAN JAVIER","1","2","0","3"
"2020-03-27","SAN JORGE","0","1","0","1"
"2020-03-27","SAN JOSE DEL RINCON","1","1","0","2"
"2020-03-27","SAN JUSTO","0","1","1","2"
"2020-03-27","SAN LORENZO","0","3","2","5"
"2020-03-27","SANTA FE","13","33","19","65"
"2020-03-27","SANTO TOME","3","3","3","9"
"2020-03-27","SASTRE","0","1","0","1"
"2020-03-27","SAUCE VIEJO","1","1","0","2"
"2020-03-27","SERODINO","0","0","1","1"
"2020-03-27","SUARDI","0","0","1","1"
"2020-03-27","SUNCHALES","0","1","1","2"
"2020-03-27","TACURAL","0","1","1","2"
"2020-03-27","VENADO TUERTO","2","5","1","8"
"2020-03-27","VERA","1","0","0","1"
"2020-03-27","VILLA CONSTITUCION","2","4","0","6"
"2020-03-27","VILLA GOBERNADOR GALVEZ","1","4","2","7"
"2020-03-27","VILLA MUGUETA","0","1","0","1"
"2020-03-28","ALVAREZ","0","1","0","1"
"2020-03-28","ANGEL GALLARDO","0","1","0","1"
"2020-03-28","ARMSTRONG","0","1","0","1"
"2020-03-28","AROCENA","0","1","1","2"
"2020-03-28","ARROYO LEYES","0","2","0","2"
"2020-03-28","ARROYO SECO","0","2","0","2"
"2020-03-28","AVELLANEDA","0","1","0","1"
"2020-03-28","CALCHAQUI","0","0","1","1"
"2020-03-28","CAÑADA DE GOMEZ","0","2","0","2"
"2020-03-28","CAPITAN BERMUDEZ","0","1","2","3"
"2020-03-28","CARCARAÑA","0","1","0","1"
"2020-03-28","CARLOS PELLEGRINI","0","1","0","1"
"2020-03-28","CARMEN","0","1","0","1"
"2020-03-28","CARRERAS","0","1","0","1"
"2020-03-28","CASILDA","2","1","3","6"
"2020-03-28","CAYASTA","0","1","0","1"
"2020-03-28","CERES","0","1","1","2"
"2020-03-28","CHABAS","1","1","1","3"
"2020-03-28","CORONDA","0","0","2","2"
"2020-03-28","CORONEL RODOLFO S. DOMINGUEZ","0","1","0","1"
"2020-03-28","DESVIO ARIJON","0","0","1","1"
"2020-03-28","ESPERANZA","1","4","1","6"
"2020-03-28","FIRMAT","0","1","0","1"
"2020-03-28","FLORENCIA","0","1","0","1"
"2020-03-28","FRANCK","1","1","2","4"
"2020-03-28","FUNES","0","1","1","2"
"2020-03-28","GABOTO","0","1","0","1"
"2020-03-28","GALVEZ","3","4","2","9"
"2020-03-28","GESSLER","0","0","1","1"
"2020-03-28","GRANADERO BAIGORRIA","0","4","0","4"
"2020-03-28","HELVECIA","2","3","3","8"
"2020-03-28","HUMBOLDT","1","0","0","1"
"2020-03-28","JOSEFINA","0","1","0","1"
"2020-03-28","LAS PAREJAS","1","0","0","1"
"2020-03-28","LAS TOSCAS","0","0","1","1"
"2020-03-28","MACIEL","0","0","1","1"
"2020-03-28","MONTE VERA","0","1","0","1"
"2020-03-28","PEREZ","0","1","0","1"
"2020-03-28","PUEBLO ANDINO","1","0","0","1"
"2020-03-28","PUEBLO ESTHER","0","2","0","2"
"2020-03-28","PUERTO GENERAL SAN MARTIN","0","1","1","2"
"2020-03-28","PUERTO RECONQUISTA","0","0","1","1"
"2020-03-28","RAFAELA","9","4","5","18"
"2020-03-28","RECONQUISTA","0","4","5","9"
"2020-03-28","RECREO","0","4","0","4"
"2020-03-28","ROLDAN","2","1","1","4"
"2020-03-28","ROSARIO","23","133","21","177"
"2020-03-28","RUFINO","0","1","0","1"
"2020-03-28","SAN CARLOS CENTRO","0","2","1","3"
"2020-03-28","SAN GENARO","0","1","0","1"
"2020-03-28","SAN JAVIER","1","2","0","3"
"2020-03-28","SAN JORGE","0","1","0","1"
"2020-03-28","SAN JOSE DEL RINCON","1","1","0","2"
"2020-03-28","SAN JUSTO","0","1","1","2"
"2020-03-28","SAN LORENZO","0","3","2","5"
"2020-03-28","SANTA FE","17","49","15","81"
"2020-03-28","SANTO TOME","4","5","4","13"
"2020-03-28","SASTRE","0","1","0","1"
"2020-03-28","SAUCE VIEJO","1","1","1","3"
"2020-03-28","SERODINO","0","1","0","1"
"2020-03-28","SUARDI","0","1","0","1"
"2020-03-28","SUNCHALES","0","1","1","2"
"2020-03-28","TACURAL","0","2","0","2"
"2020-03-28","TIMBUES","0","0","1","1"
"2020-03-28","VENADO TUERTO","2","5","1","8"
"2020-03-28","VERA","1","0","0","1"
"2020-03-28","VILLA CONSTITUCION","2","4","0","6"
"2020-03-28","VILLA GOBERNADOR GALVEZ","1","4","2","7"
"2020-03-28","VILLA MUGUETA","0","1","0","1"
"2020-03-29","ALVAREZ","0","1","0","1"
"2020-03-29","ANGEL GALLARDO","0","1","0","1"
"2020-03-29","ARMSTRONG","0","1","0","1"
"2020-03-29","AROCENA","0","2","0","2"
"2020-03-29","ARROYO LEYES","0","2","0","2"
"2020-03-29","ARROYO SECO","2","2","0","4"
"2020-03-29","AVELLANEDA","0","1","0","1"
"2020-03-29","CALCHAQUI","0","1","0","1"
"2020-03-29","CAÑADA DE GOMEZ","0","3","0","3"
"2020-03-29","CAPITAN BERMUDEZ","0","1","2","3"
"2020-03-29","CARCARAÑA","0","1","0","1"
"2020-03-29","CARLOS PELLEGRINI","0","1","0","1"
"2020-03-29","CARMEN","0","1","0","1"
"2020-03-29","CARRERAS","0","1","0","1"
"2020-03-29","CASILDA","2","3","2","7"
"2020-03-29","CAYASTA","0","1","0","1"
"2020-03-29","CERES","0","2","0","2"
"2020-03-29","CHABAS","1","2","0","3"
"2020-03-29","CORONDA","0","1","1","2"
"2020-03-29","CORONEL RODOLFO S. DOMINGUEZ","0","1","0","1"
"2020-03-29","DESVIO ARIJON","0","0","1","1"
"2020-03-29","EL RABON","0","0","1","1"
"2020-03-29","ESPERANZA","1","4","2","7"
"2020-03-29","FIRMAT","0","1","1","2"
"2020-03-29","FLORENCIA","0","1","0","1"
"2020-03-29","FRANCK","1","3","0","4"
"2020-03-29","FUNES","0","1","1","2"
"2020-03-29","GABOTO","0","1","0","1"
"2020-03-29","GALVEZ","6","3","0","9"
"2020-03-29","GESSLER","0","0","1","1"
"2020-03-29","GRANADERO BAIGORRIA","0","4","0","4"
"2020-03-29","HELVECIA","2","3","4","9"
"2020-03-29","HUMBOLDT","1","0","0","1"
"2020-03-29","JOSEFINA","0","1","0","1"
"2020-03-29","LAS PAREJAS","1","0","0","1"
"2020-03-29","LAS TOSCAS","0","1","0","1"
"2020-03-29","LOS QUIRQUINCHOS","0","0","1","1"
"2020-03-29","LUIS PALACIOS","0","0","1","1"
"2020-03-29","MACIEL","0","1","0","1"
"2020-03-29","MONTE VERA","0","1","0","1"
"2020-03-29","OLIVEROS","0","0","1","1"
"2020-03-29","PEREZ","0","1","0","1"
"2020-03-29","PUEBLO ANDINO","1","0","0","1"
"2020-03-29","PUEBLO ESTHER","0","2","0","2"
"2020-03-29","PUERTO GENERAL SAN MARTIN","0","1","1","2"
"2020-03-29","PUERTO RECONQUISTA","0","1","0","1"
"2020-03-29","RAFAELA","9","4","5","18"
"2020-03-29","RECONQUISTA","0","8","1","9"
"2020-03-29","RECREO","0","4","0","4"
"2020-03-29","ROLDAN","2","1","1","4"
"2020-03-29","ROSARIO","30","153","26","209"
"2020-03-29","RUFINO","0","1","0","1"
"2020-03-29","SAN CARLOS CENTRO","0","3","0","3"
"2020-03-29","SAN GENARO","0","1","0","1"
"2020-03-29","SAN JAVIER","1","2","0","3"
"2020-03-29","SAN JORGE","0","1","0","1"
"2020-03-29","SAN JOSE DEL RINCON","1","1","0","2"
"2020-03-29","SAN JUSTO","0","2","0","2"
"2020-03-29","SAN LORENZO","0","3","2","5"
"2020-03-29","SANTA FE","18","57","8","83"
"2020-03-29","SANTO TOME","4","9","0","13"
"2020-03-29","SASTRE","0","1","0","1"
"2020-03-29","SAUCE VIEJO","1","2","0","3"
"2020-03-29","SERODINO","0","1","0","1"
"2020-03-29","SUARDI","0","1","0","1"
"2020-03-29","SUNCHALES","0","1","1","2"
"2020-03-29","TACURAL","0","2","0","2"
"2020-03-29","TIMBUES","0","0","1","1"
"2020-03-29","TOSTADO","0","0","1","1"
"2020-03-29","VENADO TUERTO","2","5","1","8"
"2020-03-29","VERA","1","0","0","1"
"2020-03-29","VILLA CONSTITUCION","2","4","1","7"
"2020-03-29","VILLA GOBERNADOR GALVEZ","1","5","1","7"
"2020-03-29","VILLA MUGUETA","0","1","0","1"
"2020-03-30","ALVAREZ","0","1","0","1"
"2020-03-30","ANGEL GALLARDO","0","1","1","2"
"2020-03-30","ARMSTRONG","2","1","0","3"
"2020-03-30","AROCENA","0","2","0","2"
"2020-03-30","ARROYO AGUIAR","0","0","1","1"
"2020-03-30","ARROYO LEYES","0","2","0","2"
"2020-03-30","ARROYO SECO","2","2","1","5"
"2020-03-30","AVELLANEDA","0","1","0","1"
"2020-03-30","BIGAND","0","0","1","1"
"2020-03-30","CALCHAQUI","0","1","0","1"
"2020-03-30","CAÑADA DE GOMEZ","0","3","0","3"
"2020-03-30","CAPITAN BERMUDEZ","0","1","2","3"
"2020-03-30","CARCARAÑA","0","1","0","1"
"2020-03-30","CARLOS PELLEGRINI","0","1","0","1"
"2020-03-30","CARMEN","0","1","0","1"
"2020-03-30","CARRERAS","0","1","0","1"
"2020-03-30","CASILDA","2","4","2","8"
"2020-03-30","CAYASTA","0","1","0","1"
"2020-03-30","CERES","0","2","0","2"
"2020-03-30","CHABAS","1","2","0","3"
"2020-03-30","CORONDA","0","1","1","2"
"2020-03-30","CORONEL RODOLFO S. DOMINGUEZ","0","1","0","1"
"2020-03-30","DESVIO ARIJON","0","0","1","1"
"2020-03-30","EL RABON","0","1","0","1"
"2020-03-30","ESPERANZA","1","4","2","7"
"2020-03-30","FIRMAT","0","1","1","2"
"2020-03-30","FLORENCIA","0","1","0","1"
"2020-03-30","FRANCK","1","3","1","5"
"2020-03-30","FUNES","1","1","1","3"
"2020-03-30","GABOTO","0","1","0","1"
"2020-03-30","GALVEZ","6","3","0","9"
"2020-03-30","GESSLER","0","0","1","1"
"2020-03-30","GOBERNADOR CRESPO","0","0","1","1"
"2020-03-30","GRANADERO BAIGORRIA","0","5","1","6"
"2020-03-30","HELVECIA","2","3","4","9"
"2020-03-30","HUMBOLDT","1","0","0","1"
"2020-03-30","IBARLUCEA","0","1","0","1"
"2020-03-30","JOSEFINA","0","1","0","1"
"2020-03-30","LAS PAREJAS","1","0","0","1"
"2020-03-30","LAS ROSAS","0","1","0","1"
"2020-03-30","LAS TOSCAS","0","1","0","1"
"2020-03-30","LOS QUIRQUINCHOS","0","1","0","1"
"2020-03-30","LUIS PALACIOS","0","1","0","1"
"2020-03-30","MACIEL","0","1","0","1"
"2020-03-30","MONTE VERA","0","1","1","2"
"2020-03-30","OLIVEROS","0","1","0","1"
"2020-03-30","PEREZ","0","1","0","1"
"2020-03-30","PUEBLO ANDINO","1","0","1","2"
"2020-03-30","PUEBLO ESTHER","0","2","0","2"
"2020-03-30","PUERTO GENERAL SAN MARTIN","0","2","0","2"
"2020-03-30","PUERTO RECONQUISTA","0","1","0","1"
"2020-03-30","RAFAELA","10","4","13","27"
"2020-03-30","RECONQUISTA","0","8","5","13"
"2020-03-30","RECREO","0","4","0","4"
"2020-03-30","ROLDAN","3","2","1","6"
"2020-03-30","ROSARIO","44","191","25","260"
"2020-03-30","RUFINO","0","1","0","1"
"2020-03-30","SAN CARLOS CENTRO","0","3","1","4"
"2020-03-30","SAN CARLOS SUD","0","0","1","1"
"2020-03-30","SAN GENARO","0","1","0","1"
"2020-03-30","SAN JAVIER","1","2","1","4"
"2020-03-30","SAN JORGE","0","1","1","2"
"2020-03-30","SAN JOSE DEL RINCON","1","1","2","4"
"2020-03-30","SAN JUSTO","0","2","0","2"
"2020-03-30","SAN LORENZO","0","3","2","5"
"2020-03-30","SANTA FE","18","60","40","118"
"2020-03-30","SANTO TOME","4","9","8","21"
"2020-03-30","SASTRE","0","1","0","1"
"2020-03-30","SAUCE VIEJO","1","2","3","6"
"2020-03-30","SERODINO","0","1","0","1"
"2020-03-30","SUARDI","0","1","0","1"
"2020-03-30","SUNCHALES","0","1","1","2"
"2020-03-30","TACURAL","0","2","0","2"
"2020-03-30","TIMBUES","0","0","1","1"
"2020-03-30","TOSTADO","0","0","1","1"
"2020-03-30","VENADO TUERTO","2","5","1","8"
"2020-03-30","VERA","1","0","0","1"
"2020-03-30","VILLA CONSTITUCION","4","4","0","8"
"2020-03-30","VILLA GOBERNADOR GALVEZ","1","5","1","7"
"2020-03-30","VILLA MUGUETA","0","1","0","1"
"2020-03-31","ALCORTA","0","1","0","1"
"2020-03-31","ALVAREZ","0","1","0","1"
"2020-03-31","ANGEL GALLARDO","0","1","1","2"
"2020-03-31","ARMSTRONG","2","1","0","3"
"2020-03-31","AROCENA","0","2","0","2"
"2020-03-31","ARROYO AGUIAR","0","0","1","1"
"2020-03-31","ARROYO LEYES","0","3","0","3"
"2020-03-31","ARROYO SECO","2","3","0","5"
"2020-03-31","AVELLANEDA","0","1","1","2"
"2020-03-31","BIGAND","0","1","0","1"
"2020-03-31","CALCHAQUI","0","1","0","1"
"2020-03-31","CAÑADA DE GOMEZ","1","3","0","4"
"2020-03-31","CAPITAN BERMUDEZ","0","1","2","3"
"2020-03-31","CARCARAÑA","0","1","1","2"
"2020-03-31","CARLOS PELLEGRINI","0","1","0","1"
"2020-03-31","CARMEN","0","1","0","1"
"2020-03-31","CARRERAS","0","1","0","1"
"2020-03-31","CASILDA","2","6","1","9"
"2020-03-31","CAYASTA","0","1","1","2"
"2020-03-31","CERES","0","2","0","2"
"2020-03-31","CHABAS","1","2","0","3"
"2020-03-31","CORONDA","0","2","0","2"
"2020-03-31","CORONEL RODOLFO S. DOMINGUEZ","0","1","0","1"
"2020-03-31","DESVIO ARIJON","0","1","0","1"
"2020-03-31","ELORTONDO","2","0","0","2"
"2020-03-31","EL RABON","0","1","0","1"
"2020-03-31","ESPERANZA","1","5","4","10"
"2020-03-31","FIRMAT","0","2","0","2"
"2020-03-31","FLORENCIA","0","1","0","1"
"2020-03-31","FRANCK","1","3","1","5"
"2020-03-31","FUNES","1","4","1","6"
"2020-03-31","GABOTO","0","1","0","1"
"2020-03-31","GALVEZ","6","3","1","10"
"2020-03-31","GESSLER","0","0","1","1"
"2020-03-31","GOBERNADOR CRESPO","0","0","1","1"
"2020-03-31","GRANADERO BAIGORRIA","0","5","1","6"
"2020-03-31","HELVECIA","2","6","1","9"
"2020-03-31","HUMBOLDT","1","0","1","2"
"2020-03-31","IBARLUCEA","0","1","0","1"
"2020-03-31","JOSEFINA","0","1","0","1"
"2020-03-31","LAGUNA PAIVA","0","1","0","1"
"2020-03-31","LAS PAREJAS","1","0","0","1"
"2020-03-31","LAS ROSAS","0","1","0","1"
"2020-03-31","LAS TOSCAS","0","1","0","1"
"2020-03-31","LOPEZ","0","0","1","1"
"2020-03-31","LOS QUIRQUINCHOS","0","1","0","1"
"2020-03-31","LUIS PALACIOS","0","1","0","1"
"2020-03-31","MACIEL","0","1","0","1"
"2020-03-31","MONTE VERA","0","3","0","3"
"2020-03-31","OLIVEROS","0","1","0","1"
"2020-03-31","PEREZ","0","1","1","2"
"2020-03-31","PUEBLO ANDINO","2","0","0","2"
"2020-03-31","PUEBLO ESTHER","0","2","0","2"
"2020-03-31","PUERTO GENERAL SAN MARTIN","0","2","0","2"
"2020-03-31","PUERTO RECONQUISTA","0","1","0","1"
"2020-03-31","PUJATO","2","0","1","3"
"2020-03-31","RAFAELA","13","8","16","37"
"2020-03-31","RECONQUISTA","0","13","1","14"
"2020-03-31","RECREO","0","4","0","4"
"2020-03-31","RICARDONE","0","0","1","1"
"2020-03-31","ROLDAN","4","2","2","8"
"2020-03-31","ROSARIO","51","226","27","304"
"2020-03-31","RUFINO","0","1","0","1"
"2020-03-31","SAN CARLOS CENTRO","0","4","0","4"
"2020-03-31","SAN CARLOS SUD","1","0","0","1"
"2020-03-31","SAN GENARO","0","1","0","1"
"2020-03-31","SAN JAVIER","1","3","0","4"
"2020-03-31","SAN JORGE","0","2","0","2"
"2020-03-31","SAN JOSE DE LA ESQUINA","0","0","1","1"
"2020-03-31","SAN JOSE DEL RINCON","1","2","1","4"
"2020-03-31","SAN JUSTO","0","2","0","2"
"2020-03-31","SAN LORENZO","0","3","4","7"
"2020-03-31","SANTA FE","22","88","26","136"
"2020-03-31","SANTO TOME","4","12","6","22"
"2020-03-31","SASTRE","0","1","0","1"
"2020-03-31","SAUCE VIEJO","1","4","1","6"
"2020-03-31","SERODINO","0","1","0","1"
"2020-03-31","SUARDI","0","1","0","1"
"2020-03-31","SUNCHALES","0","1","1","2"
"2020-03-31","TACURAL","0","2","0","2"
"2020-03-31","TIMBUES","0","0","1","1"
"2020-03-31","TOSTADO","0","1","0","1"
"2020-03-31","VENADO TUERTO","2","7","0","9"
"2020-03-31","VERA","1","0","0","1"
"2020-03-31","VILLA CONSTITUCION","4","4","0","8"
"2020-03-31","VILLA GOBERNADOR GALVEZ","1","5","5","11"
"2020-03-31","VILLA MUGUETA","0","1","0","1"
"2020-04-01","ALCORTA","0","1","0","1"
"2020-04-01","ALVAREZ","0","1","0","1"
"2020-04-01","ANGEL GALLARDO","0","1","1","2"
"2020-04-01","ARMSTRONG","2","1","0","3"
"2020-04-01","AROCENA","0","2","0","2"
"2020-04-01","ARROYO AGUIAR","0","1","0","1"
"2020-04-01","ARROYO LEYES","0","3","0","3"
"2020-04-01","ARROYO SECO","2","3","0","5"
"2020-04-01","AVELLANEDA","0","1","3","4"
"2020-04-01","BIGAND","0","1","0","1"
"2020-04-01","CALCHAQUI","0","1","0","1"
"2020-04-01","CAÑADA DE GOMEZ","1","3","0","4"
"2020-04-01","CAPITAN BERMUDEZ","0","1","2","3"
"2020-04-01","CARCARAÑA","0","2","0","2"
"2020-04-01","CARLOS PELLEGRINI","0","1","0","1"
"2020-04-01","CARMEN","0","1","0","1"
"2020-04-01","CARRERAS","0","1","0","1"
"2020-04-01","CASILDA","2","6","2","10"
"2020-04-01","CAYASTA","0","2","0","2"
"2020-04-01","CERES","0","2","0","2"
"2020-04-01","CHABAS","1","2","0","3"
"2020-04-01","CORONDA","0","2","0","2"
"2020-04-01","CORONEL RODOLFO S. DOMINGUEZ","0","1","0","1"
"2020-04-01","DESVIO ARIJON","0","1","0","1"
"2020-04-01","ELORTONDO","2","0","0","2"
"2020-04-01","EL RABON","0","1","0","1"
"2020-04-01","ESPERANZA","1","6","3","10"
"2020-04-01","FIRMAT","0","2","0","2"
"2020-04-01","FLORENCIA","0","1","0","1"
"2020-04-01","FRANCK","1","4","0","5"
"2020-04-01","FRAY LUIS BELTRAN","0","0","1","1"
"2020-04-01","FUNES","2","5","1","8"
"2020-04-01","GABOTO","0","1","0","1"
"2020-04-01","GALVEZ","7","3","1","11"
"2020-04-01","GESSLER","0","0","1","1"
"2020-04-01","GOBERNADOR CRESPO","0","0","1","1"
"2020-04-01","GRANADERO BAIGORRIA","0","5","1","6"
"2020-04-01","HELVECIA","2","6","1","9"
"2020-04-01","HUMBOLDT","1","0","1","2"
"2020-04-01","IBARLUCEA","0","1","0","1"
"2020-04-01","JOSEFINA","0","1","0","1"
"2020-04-01","LA BRAVA","0","0","1","1"
"2020-04-01","LAGUNA PAIVA","0","1","0","1"
"2020-04-01","LAS PAREJAS","1","0","0","1"
"2020-04-01","LAS ROSAS","0","1","0","1"
"2020-04-01","LAS TOSCAS","0","1","0","1"
"2020-04-01","LOPEZ","0","0","1","1"
"2020-04-01","LOS QUIRQUINCHOS","0","1","0","1"
"2020-04-01","LUIS PALACIOS","0","1","0","1"
"2020-04-01","MACIEL","0","1","0","1"
"2020-04-01","MALABRIGO","0","0","1","1"
"2020-04-01","MONTE VERA","0","3","0","3"
"2020-04-01","OLIVEROS","0","1","0","1"
"2020-04-01","PEREZ","0","1","4","5"
"2020-04-01","PUEBLO ANDINO","2","0","0","2"
"2020-04-01","PUEBLO ESTHER","0","2","0","2"
"2020-04-01","PUERTO GENERAL SAN MARTIN","0","2","0","2"
"2020-04-01","PUERTO RECONQUISTA","0","1","0","1"
"2020-04-01","PUJATO","2","2","0","4"
"2020-04-01","RAFAELA","13","9","22","44"
"2020-04-01","RECONQUISTA","0","13","3","16"
"2020-04-01","RECREO","0","4","1","5"
"2020-04-01","RICARDONE","0","1","0","1"
"2020-04-01","ROLDAN","4","3","1","8"
"2020-04-01","ROSARIO","56","235","54","345"
"2020-04-01","RUFINO","0","1","0","1"
"2020-04-01","SAN CARLOS CENTRO","0","4","0","4"
"2020-04-01","SAN CARLOS SUD","1","0","0","1"
"2020-04-01","SAN GENARO","1","1","0","2"
"2020-04-01","SAN JAVIER","1","3","0","4"
"2020-04-01","SAN JORGE","0","1","2","3"
"2020-04-01","SAN JOSE DE LA ESQUINA","0","1","0","1"
"2020-04-01","SAN JOSE DEL RINCON","1","3","1","5"
"2020-04-01","SAN JUSTO","0","2","0","2"
"2020-04-01","SAN LORENZO","0","4","6","10"
"2020-04-01","SANTA FE","22","106","18","146"
"2020-04-01","SANTO TOME","4","16","5","25"
"2020-04-01","SASTRE","0","1","0","1"
"2020-04-01","SAUCE VIEJO","1","5","0","6"
"2020-04-01","SERODINO","0","1","0","1"
"2020-04-01","SUARDI","0","1","0","1"
"2020-04-01","SUNCHALES","0","2","0","2"
"2020-04-01","TACURAL","0","2","0","2"
"2020-04-01","TIMBUES","0","1","1","2"
"2020-04-01","TOSTADO","0","1","0","1"
"2020-04-01","VENADO TUERTO","3","7","0","10"
"2020-04-01","VERA","1","0","0","1"
"2020-04-01","VILLA CONSTITUCION","5","4","0","9"
"2020-04-01","VILLA GOBERNADOR GALVEZ","2","10","1","13"
"2020-04-01","VILLA MUGUETA","0","1","0","1"
"2020-04-02","ALCORTA","0","1","0","1"
"2020-04-02","ALVAREZ","0","1","0","1"
"2020-04-02","ALVEAR","0","0","1","1"
"2020-04-02","ANGEL GALLARDO","0","2","0","2"
"2020-04-02","ARMSTRONG","2","1","0","3"
"2020-04-02","AROCENA","0","3","0","3"
"2020-04-02","ARROYO AGUIAR","0","1","0","1"
"2020-04-02","ARROYO LEYES","0","3","0","3"
"2020-04-02","ARROYO SECO","2","3","0","5"
"2020-04-02","AVELLANEDA","0","2","3","5"
"2020-04-02","BARRANCAS","0","0","1","1"
"2020-04-02","BIGAND","0","1","0","1"
"2020-04-02","CALCHAQUI","0","1","0","1"
"2020-04-02","CAÑADA DE GOMEZ","1","3","0","4"
"2020-04-02","CAPITAN BERMUDEZ","0","3","1","4"
"2020-04-02","CARCARAÑA","0","2","2","4"
"2020-04-02","CARLOS PELLEGRINI","0","1","0","1"
"2020-04-02","CARMEN","0","1","0","1"
"2020-04-02","CARRERAS","0","1","0","1"
"2020-04-02","CASILDA","2","7","2","11"
"2020-04-02","CAYASTA","0","2","0","2"
"2020-04-02","CERES","0","2","4","6"
"2020-04-02","CHABAS","1","2","0","3"
"2020-04-02","CORONDA","0","4","0","4"
"2020-04-02","CORONEL RODOLFO S. DOMINGUEZ","0","1","0","1"
"2020-04-02","DESVIO ARIJON","0","1","0","1"
"2020-04-02","ELORTONDO","2","0","0","2"
"2020-04-02","EL RABON","0","1","0","1"
"2020-04-02","ESPERANZA","1","8","2","11"
"2020-04-02","FIRMAT","0","2","0","2"
"2020-04-02","FLORENCIA","0","1","0","1"
"2020-04-02","FRANCK","1","4","0","5"
"2020-04-02","FRAY LUIS BELTRAN","0","0","3","3"
"2020-04-02","FUNES","3","7","2","12"
"2020-04-02","GABOTO","0","1","0","1"
"2020-04-02","GALVEZ","7","3","2","12"
"2020-04-02","GESSLER","0","0","1","1"
"2020-04-02","GOBERNADOR CRESPO","0","0","1","1"
"2020-04-02","GRANADERO BAIGORRIA","0","6","3","9"
"2020-04-02","HELVECIA","2","6","1","9"
"2020-04-02","HUMBOLDT","1","1","0","2"
"2020-04-02","IBARLUCEA","0","1","0","1"
"2020-04-02","JOSEFINA","0","1","0","1"
"2020-04-02","LA BRAVA","0","0","1","1"
"2020-04-02","LA CRIOLLA","0","0","1","1"
"2020-04-02","LAGUNA PAIVA","0","1","0","1"
"2020-04-02","LAS PAREJAS","1","0","0","1"
"2020-04-02","LAS ROSAS","0","1","0","1"
"2020-04-02","LAS TOSCAS","0","1","0","1"
"2020-04-02","LOPEZ","0","0","1","1"
"2020-04-02","LOS QUIRQUINCHOS","0","1","0","1"
"2020-04-02","LUIS PALACIOS","0","1","0","1"
"2020-04-02","MACIEL","0","1","0","1"
"2020-04-02","MALABRIGO","0","0","1","1"
"2020-04-02","MONTE VERA","0","3","0","3"
"2020-04-02","OLIVEROS","0","2","0","2"
"2020-04-02","PAVON ARRIBA","0","1","0","1"
"2020-04-02","PEREZ","0","5","1","6"
"2020-04-02","PILAR","0","0","1","1"
"2020-04-02","PUEBLO ANDINO","2","0","0","2"
"2020-04-02","PUEBLO ESTHER","0","2","0","2"
"2020-04-02","PUERTO GENERAL SAN MARTIN","0","2","0","2"
"2020-04-02","PUERTO RECONQUISTA","0","1","0","1"
"2020-04-02","PUJATO","2","2","0","4"
"2020-04-02","RAFAELA","17","19","10","46"
"2020-04-02","RECONQUISTA","0","16","3","19"
"2020-04-02","RECREO","0","4","1","5"
"2020-04-02","RICARDONE","0","1","0","1"
"2020-04-02","ROLDAN","4","3","2","9"
"2020-04-02","ROSARIO","58","294","60","412"
"2020-04-02","RUFINO","0","1","0","1"
"2020-04-02","SAN CARLOS CENTRO","0","4","0","4"
"2020-04-02","SAN CARLOS SUD","1","0","0","1"
"2020-04-02","SAN GENARO","1","1","0","2"
"2020-04-02","SAN JAVIER","1","3","0","4"
"2020-04-02","SAN JORGE","0","2","1","3"
"2020-04-02","SAN JOSE DE LA ESQUINA","0","1","1","2"
"2020-04-02","SAN JOSE DEL RINCON","1","3","1","5"
"2020-04-02","SAN JUSTO","0","2","0","2"
"2020-04-02","SAN LORENZO","1","5","5","11"
"2020-04-02","SANTA FE","22","120","28","170"
"2020-04-02","SANTO TOME","4","22","2","28"
"2020-04-02","SASTRE","0","1","0","1"
"2020-04-02","SAUCE VIEJO","1","5","0","6"
"2020-04-02","SERODINO","0","1","0","1"
"2020-04-02","SUARDI","0","2","0","2"
"2020-04-02","SUNCHALES","0","2","1","3"
"2020-04-02","TACURAL","0","2","0","2"
"2020-04-02","TIMBUES","0","1","1","2"
"2020-04-02","TOSTADO","0","1","0","1"
"2020-04-02","VENADO TUERTO","3","7","0","10"
"2020-04-02","VERA","1","2","0","3"
"2020-04-02","VILLA CONSTITUCION","5","4","0","9"
"2020-04-02","VILLA GOBERNADOR GALVEZ","2","10","3","15"
"2020-04-02","VILLA MUGUETA","0","1","0","1"
"2020-04-03","ALCORTA","0","1","0","1"
"2020-04-03","ALVAREZ","0","1","0","1"
"2020-04-03","ALVEAR","0","1","1","2"
"2020-04-03","ANGEL GALLARDO","0","2","0","2"
"2020-04-03","ARMSTRONG","2","1","0","3"
"2020-04-03","AROCENA","0","3","0","3"
"2020-04-03","ARROYO AGUIAR","0","1","0","1"
"2020-04-03","ARROYO LEYES","0","3","1","4"
"2020-04-03","ARROYO SECO","2","3","0","5"
"2020-04-03","AVELLANEDA","0","3","2","5"
"2020-04-03","BARRANCAS","0","0","1","1"
"2020-04-03","BIGAND","0","1","0","1"
"2020-04-03","CALCHAQUI","0","1","0","1"
"2020-04-03","CAÑADA DE GOMEZ","1","3","0","4"
"2020-04-03","CAPITAN BERMUDEZ","0","4","1","5"
"2020-04-03","CARCARAÑA","0","3","2","5"
"2020-04-03","CARLOS PELLEGRINI","0","1","0","1"
"2020-04-03","CARMEN","0","1","0","1"
"2020-04-03","CARRERAS","0","1","0","1"
"2020-04-03","CARRIZALES","0","0","1","1"
"2020-04-03","CASILDA","2","8","1","11"
"2020-04-03","CAYASTA","0","2","0","2"
"2020-04-03","CERES","0","2","5","7"
"2020-04-03","CHABAS","1","2","0","3"
"2020-04-03","CORONDA","0","5","0","5"
"2020-04-03","CORONEL RODOLFO S. DOMINGUEZ","0","1","0","1"
"2020-04-03","DESVIO ARIJON","0","1","0","1"
"2020-04-03","ELORTONDO","2","0","0","2"
"2020-04-03","EL RABON","0","1","0","1"
"2020-04-03","ESPERANZA","1","8","3","12"
"2020-04-03","FIRMAT","0","2","0","2"
"2020-04-03","FLORENCIA","0","1","0","1"
"2020-04-03","FRANCK","1","4","0","5"
"2020-04-03","FRAY LUIS BELTRAN","0","3","0","3"
"2020-04-03","FUNES","3","11","2","16"
"2020-04-03","GABOTO","0","1","0","1"
"2020-04-03","GALVEZ","7","5","0","12"
"2020-04-03","GESSLER","0","0","1","1"
"2020-04-03","GOBERNADOR CRESPO","0","1","0","1"
"2020-04-03","GRANADERO BAIGORRIA","0","8","2","10"
"2020-04-03","HELVECIA","2","7","2","11"
"2020-04-03","HUMBOLDT","1","1","0","2"
"2020-04-03","IBARLUCEA","0","2","0","2"
"2020-04-03","JOSEFINA","0","2","0","2"
"2020-04-03","LA BRAVA","0","1","0","1"
"2020-04-03","LA CRIOLLA","0","1","0","1"
"2020-04-03","LAGUNA PAIVA","0","1","0","1"
"2020-04-03","LAS PAREJAS","1","0","0","1"
"2020-04-03","LAS ROSAS","0","1","0","1"
"2020-04-03","LAS TOSCAS","0","1","0","1"
"2020-04-03","LOPEZ","0","1","0","1"
"2020-04-03","LOS QUIRQUINCHOS","0","1","0","1"
"2020-04-03","LUIS PALACIOS","0","1","0","1"
"2020-04-03","MACIEL","0","1","0","1"
"2020-04-03","MALABRIGO","0","1","0","1"
"2020-04-03","MONTE VERA","0","3","0","3"
"2020-04-03","OLIVEROS","0","2","0","2"
"2020-04-03","PAVON ARRIBA","0","1","0","1"
"2020-04-03","PEREZ","0","7","0","7"
"2020-04-03","PILAR","0","0","1","1"
"2020-04-03","PUEBLO ANDINO","2","0","0","2"
"2020-04-03","PUEBLO ESTHER","0","2","1","3"
"2020-04-03","PUERTO GENERAL SAN MARTIN","0","2","0","2"
"2020-04-03","PUERTO RECONQUISTA","0","1","0","1"
"2020-04-03","PUJATO","2","2","0","4"
"2020-04-03","RAFAELA","18","21","8","47"
"2020-04-03","RECONQUISTA","0","18","3","21"
"2020-04-03","RECREO","0","5","0","5"
"2020-04-03","RICARDONE","0","1","0","1"
"2020-04-03","ROLDAN","4","7","1","12"
"2020-04-03","ROSARIO","65","352","57","474"
"2020-04-03","RUFINO","0","1","0","1"
"2020-04-03","SAN CARLOS CENTRO","0","4","0","4"
"2020-04-03","SAN CARLOS SUD","1","0","0","1"
"2020-04-03","SAN GENARO","1","1","0","2"
"2020-04-03","SAN JAVIER","1","3","0","4"
"2020-04-03","SAN JORGE","0","3","1","4"
"2020-04-03","SAN JOSE DE LA ESQUINA","0","2","0","2"
"2020-04-03","SAN JOSE DEL RINCON","1","3","1","5"
"2020-04-03","SAN JUSTO","0","2","0","2"
"2020-04-03","SAN LORENZO","1","8","5","14"
"2020-04-03","SANTA FE","22","153","23","198"
"2020-04-03","SANTO TOME","4","24","3","31"
"2020-04-03","SASTRE","0","1","0","1"
"2020-04-03","SAUCE VIEJO","1","6","0","7"
"2020-04-03","SERODINO","0","1","0","1"
"2020-04-03","SUARDI","0","2","0","2"
"2020-04-03","SUNCHALES","0","3","0","3"
"2020-04-03","TACURAL","0","2","0","2"
"2020-04-03","TIMBUES","0","1","1","2"
"2020-04-03","TOSTADO","0","1","0","1"
"2020-04-03","VENADO TUERTO","3","7","0","10"
"2020-04-03","VERA","1","2","0","3"
"2020-04-03","VILLA CONSTITUCION","5","5","0","10"
"2020-04-03","VILLA GOBERNADOR GALVEZ","2","13","6","21"
"2020-04-03","VILLA MUGUETA","0","1","0","1"
"2020-04-04","ALCORTA","0","1","0","1"
"2020-04-04","ALVAREZ","0","1","0","1"
"2020-04-04","ALVEAR","0","1","1","2"
"2020-04-04","ANGEL GALLARDO","0","2","0","2"
"2020-04-04","ARMSTRONG","2","1","0","3"
"2020-04-04","AROCENA","0","3","0","3"
"2020-04-04","ARROYO AGUIAR","0","1","0","1"
"2020-04-04","ARROYO LEYES","0","4","0","4"
"2020-04-04","ARROYO SECO","2","3","1","6"
"2020-04-04","AVELLANEDA","0","3","2","5"
"2020-04-04","BARRANCAS","0","1","0","1"
"2020-04-04","BIGAND","0","1","0","1"
"2020-04-04","CALCHAQUI","0","1","1","2"
"2020-04-04","CAÑADA DE GOMEZ","1","3","0","4"
"2020-04-04","CAÑADA DEL UCLE","0","0","1","1"
"2020-04-04","CAPITAN BERMUDEZ","0","4","1","5"
"2020-04-04","CARCARAÑA","0","4","1","5"
"2020-04-04","CARLOS PELLEGRINI","0","1","0","1"
"2020-04-04","CARMEN","0","1","0","1"
"2020-04-04","CARRERAS","0","1","0","1"
"2020-04-04","CARRIZALES","0","1","0","1"
"2020-04-04","CASILDA","2","8","4","14"
"2020-04-04","CAYASTA","0","2","0","2"
"2020-04-04","CERES","0","7","0","7"
"2020-04-04","CHABAS","1","2","0","3"
"2020-04-04","CORONDA","0","5","0","5"
"2020-04-04","CORONEL RODOLFO S. DOMINGUEZ","0","1","0","1"
"2020-04-04","DESVIO ARIJON","0","1","0","1"
"2020-04-04","ELORTONDO","2","0","1","3"
"2020-04-04","EL RABON","0","1","0","1"
"2020-04-04","ESPERANZA","1","10","1","12"
"2020-04-04","FIRMAT","1","2","0","3"
"2020-04-04","FLORENCIA","0","1","0","1"
"2020-04-04","FRANCK","1","4","0","5"
"2020-04-04","FRAY LUIS BELTRAN","0","3","1","4"
"2020-04-04","FUNES","3","12","2","17"
"2020-04-04","GABOTO","0","2","0","2"
"2020-04-04","GALVEZ","7","5","1","13"
"2020-04-04","GESSLER","0","0","1","1"
"2020-04-04","GOBERNADOR CRESPO","0","1","0","1"
"2020-04-04","GRANADERO BAIGORRIA","0","8","3","11"
"2020-04-04","HELVECIA","2","7","2","11"
"2020-04-04","HUMBOLDT","1","1","0","2"
"2020-04-04","IBARLUCEA","0","2","0","2"
"2020-04-04","JOSEFINA","0","2","0","2"
"2020-04-04","LA BRAVA","0","1","0","1"
"2020-04-04","LA CRIOLLA","0","1","0","1"
"2020-04-04","LAGUNA PAIVA","0","1","0","1"
"2020-04-04","LAS PAREJAS","1","0","0","1"
"2020-04-04","LAS ROSAS","0","1","0","1"
"2020-04-04","LAS TOSCAS","0","1","0","1"
"2020-04-04","LLAMBI CAMPBELL","0","0","3","3"
"2020-04-04","LOPEZ","0","1","0","1"
"2020-04-04","LOS QUIRQUINCHOS","0","1","0","1"
"2020-04-04","LUIS PALACIOS","0","1","0","1"
"2020-04-04","MACIEL","0","1","0","1"
"2020-04-04","MALABRIGO","0","1","0","1"
"2020-04-04","MONTE VERA","0","3","1","4"
"2020-04-04","OLIVEROS","0","2","0","2"
"2020-04-04","PAVON ARRIBA","0","1","0","1"
"2020-04-04","PEREZ","0","7","1","8"
"2020-04-04","PILAR","0","1","0","1"
"2020-04-04","PUEBLO ANDINO","2","0","0","2"
"2020-04-04","PUEBLO ESTHER","0","2","1","3"
"2020-04-04","PUERTO GENERAL SAN MARTIN","0","3","0","3"
"2020-04-04","PUERTO RECONQUISTA","0","1","0","1"
"2020-04-04","PUJATO","2","2","0","4"
"2020-04-04","RAFAELA","18","21","11","50"
"2020-04-04","RECONQUISTA","0","19","2","21"
"2020-04-04","RECREO","0","5","1","6"
"2020-04-04","RICARDONE","0","1","0","1"
"2020-04-04","ROLDAN","4","7","1","12"
"2020-04-04","ROSARIO","68","400","45","513"
"2020-04-04","RUFINO","0","1","0","1"
"2020-04-04","SAN CARLOS CENTRO","0","4","2","6"
"2020-04-04","SAN CARLOS SUD","1","0","0","1"
"2020-04-04","SAN GENARO","1","1","0","2"
"2020-04-04","SAN JAVIER","1","3","0","4"
"2020-04-04","SAN JERONIMO NORTE","0","0","1","1"
"2020-04-04","SAN JERONIMO SUD","0","1","1","2"
"2020-04-04","SAN JORGE","0","3","1","4"
"2020-04-04","SAN JOSE DE LA ESQUINA","0","2","0","2"
"2020-04-04","SAN JOSE DEL RINCON","1","3","1","5"
"2020-04-04","SAN JUSTO","0","2","1","3"
"2020-04-04","SAN LORENZO","1","9","5","15"
"2020-04-04","SANTA FE","23","161","33","217"
"2020-04-04","SANTO TOME","4","27","2","33"
"2020-04-04","SARMIENTO","0","0","2","2"
"2020-04-04","SASTRE","0","1","0","1"
"2020-04-04","SAUCE VIEJO","1","6","0","7"
"2020-04-04","SERODINO","0","1","0","1"
"2020-04-04","SUARDI","0","2","0","2"
"2020-04-04","SUNCHALES","0","3","0","3"
"2020-04-04","TACURAL","0","2","0","2"
"2020-04-04","TIMBUES","0","2","1","3"
"2020-04-04","TOSTADO","0","1","0","1"
"2020-04-04","VENADO TUERTO","3","7","1","11"
"2020-04-04","VERA","1","2","2","5"
"2020-04-04","VILLA CONSTITUCION","5","5","2","12"
"2020-04-04","VILLA GOBERNADOR GALVEZ","2","16","5","23"
"2020-04-04","VILLA MUGUETA","0","1","0","1"
"2020-04-05","ALCORTA","0","1","0","1"
"2020-04-05","ALVAREZ","0","1","0","1"
"2020-04-05","ALVEAR","0","1","1","2"
"2020-04-05","ANGEL GALLARDO","0","2","0","2"
"2020-04-05","ARMSTRONG","2","1","0","3"
"2020-04-05","AROCENA","0","3","0","3"
"2020-04-05","ARROYO AGUIAR","0","1","0","1"
"2020-04-05","ARROYO LEYES","0","4","0","4"
"2020-04-05","ARROYO SECO","2","4","0","6"
"2020-04-05","AVELLANEDA","0","3","2","5"
"2020-04-05","BARRANCAS","0","1","0","1"
"2020-04-05","BIGAND","0","1","0","1"
"2020-04-05","CALCHAQUI","0","2","0","2"
"2020-04-05","CAÑADA DE GOMEZ","1","3","0","4"
"2020-04-05","CAÑADA DEL UCLE","0","1","0","1"
"2020-04-05","CAPITAN BERMUDEZ","0","5","0","5"
"2020-04-05","CARCARAÑA","0","4","1","5"
"2020-04-05","CARLOS PELLEGRINI","0","1","0","1"
"2020-04-05","CARMEN","0","1","0","1"
"2020-04-05","CARRERAS","0","1","0","1"
"2020-04-05","CARRIZALES","0","1","0","1"
"2020-04-05","CASILDA","2","10","6","18"
"2020-04-05","CAYASTA","0","2","0","2"
"2020-04-05","CERES","0","7","0","7"
"2020-04-05","CHABAS","1","2","0","3"
"2020-04-05","CORONDA","0","5","0","5"
"2020-04-05","CORONEL RODOLFO S. DOMINGUEZ","0","1","1","2"
"2020-04-05","DESVIO ARIJON","0","1","0","1"
"2020-04-05","ELORTONDO","2","0","1","3"
"2020-04-05","EL RABON","0","1","0","1"
"2020-04-05","ESPERANZA","1","10","1","12"
"2020-04-05","FIRMAT","1","3","0","4"
"2020-04-05","FLORENCIA","0","1","0","1"
"2020-04-05","FRANCK","1","4","0","5"
"2020-04-05","FRAY LUIS BELTRAN","0","3","1","4"
"2020-04-05","FUNES","3","14","1","18"
"2020-04-05","GABOTO","0","2","0","2"
"2020-04-05","GALVEZ","7","6","1","14"
"2020-04-05","GESSLER","0","0","1","1"
"2020-04-05","GOBERNADOR CRESPO","0","1","0","1"
"2020-04-05","GRANADERO BAIGORRIA","0","11","3","14"
"2020-04-05","HELVECIA","2","10","1","13"
"2020-04-05","HUMBOLDT","1","1","0","2"
"2020-04-05","IBARLUCEA","0","2","0","2"
"2020-04-05","JOSEFINA","0","2","0","2"
"2020-04-05","LA BRAVA","0","1","0","1"
"2020-04-05","LA CRIOLLA","0","1","0","1"
"2020-04-05","LAGUNA PAIVA","0","1","0","1"
"2020-04-05","LAS PAREJAS","1","0","0","1"
"2020-04-05","LAS ROSAS","0","1","0","1"
"2020-04-05","LAS TOSCAS","0","1","0","1"
"2020-04-05","LLAMBI CAMPBELL","3","0","0","3"
"2020-04-05","LOPEZ","0","1","0","1"
"2020-04-05","LOS QUIRQUINCHOS","0","1","0","1"
"2020-04-05","LUIS PALACIOS","0","1","0","1"
"2020-04-05","MACIEL","0","1","0","1"
"2020-04-05","MALABRIGO","0","1","0","1"
"2020-04-05","MONTE VERA","0","4","1","5"
"2020-04-05","OLIVEROS","0","2","0","2"
"2020-04-05","PAVON ARRIBA","0","1","0","1"
"2020-04-05","PEREZ","0","7","2","9"
"2020-04-05","PILAR","0","1","0","1"
"2020-04-05","PUEBLO ANDINO","2","0","0","2"
"2020-04-05","PUEBLO ESTHER","0","3","0","3"
"2020-04-05","PUERTO GENERAL SAN MARTIN","0","3","0","3"
"2020-04-05","PUERTO RECONQUISTA","0","1","0","1"
"2020-04-05","PUJATO","2","2","0","4"
"2020-04-05","RAFAELA","18","23","9","50"
"2020-04-05","RECONQUISTA","0","19","2","21"
"2020-04-05","RECREO","0","6","0","6"
"2020-04-05","RICARDONE","0","1","0","1"
"2020-04-05","ROLDAN","4","7","1","12"
"2020-04-05","ROSARIO","73","446","21","540"
"2020-04-05","RUFINO","0","1","0","1"
"2020-04-05","SALTO GRANDE","0","1","0","1"
"2020-04-05","SAN CARLOS CENTRO","0","6","0","6"
"2020-04-05","SAN CARLOS SUD","1","0","0","1"
"2020-04-05","SAN GENARO","1","1","0","2"
"2020-04-05","SAN JAVIER","1","3","0","4"
"2020-04-05","SAN JERONIMO NORTE","0","1","0","1"
"2020-04-05","SAN JERONIMO SUD","0","2","1","3"
"2020-04-05","SAN JORGE","0","4","0","4"
"2020-04-05","SAN JOSE DE LA ESQUINA","0","2","0","2"
"2020-04-05","SAN JOSE DEL RINCON","1","3","1","5"
"2020-04-05","SAN JUSTO","0","3","0","3"
"2020-04-05","SAN LORENZO","1","11","5","17"
"2020-04-05","SANTA FE","23","189","11","223"
"2020-04-05","SANTO TOME","5","29","0","34"
"2020-04-05","SARMIENTO","0","2","0","2"
"2020-04-05","SASTRE","0","1","0","1"
"2020-04-05","SAUCE VIEJO","1","7","0","8"
"2020-04-05","SERODINO","0","1","0","1"
"2020-04-05","SUARDI","0","2","0","2"
"2020-04-05","SUNCHALES","0","3","0","3"
"2020-04-05","TACURAL","0","2","0","2"
"2020-04-05","TIMBUES","0","2","1","3"
"2020-04-05","TOSTADO","0","1","0","1"
"2020-04-05","VENADO TUERTO","4","7","0","11"
"2020-04-05","VERA","1","4","1","6"
"2020-04-05","VILLA CONSTITUCION","6","8","0","14"
"2020-04-05","VILLA GOBERNADOR GALVEZ","2","22","2","26"
"2020-04-05","VILLA MUGUETA","0","1","0","1"
"2020-04-06","ALCORTA","0","1","0","1"
"2020-04-06","ALVAREZ","0","1","0","1"
"2020-04-06","ALVEAR","0","1","1","2"
"2020-04-06","ANGEL GALLARDO","0","2","0","2"
"2020-04-06","ARMSTRONG","2","2","0","4"
"2020-04-06","AROCENA","0","3","0","3"
"2020-04-06","ARROYO AGUIAR","0","1","0","1"
"2020-04-06","ARROYO LEYES","0","5","0","5"
"2020-04-06","ARROYO SECO","2","4","0","6"
"2020-04-06","AVELLANEDA","0","3","4","7"
"2020-04-06","BARRANCAS","0","1","0","1"
"2020-04-06","BIGAND","0","1","0","1"
"2020-04-06","BOMBAL","0","1","0","1"
"2020-04-06","CALCHAQUI","0","2","1","3"
"2020-04-06","CAÑADA DE GOMEZ","1","5","0","6"
"2020-04-06","CAÑADA DEL UCLE","0","1","0","1"
"2020-04-06","CAPITAN BERMUDEZ","0","7","0","7"
"2020-04-06","CARCARAÑA","0","4","1","5"
"2020-04-06","CARLOS PELLEGRINI","0","1","0","1"
"2020-04-06","CARMEN","0","1","0","1"
"2020-04-06","CARRERAS","0","2","0","2"
"2020-04-06","CARRIZALES","0","1","0","1"
"2020-04-06","CASILDA","2","10","6","18"
"2020-04-06","CAYASTA","0","2","0","2"
"2020-04-06","CERES","0","7","0","7"
"2020-04-06","CHABAS","1","2","0","3"
"2020-04-06","CORONDA","0","7","0","7"
"2020-04-06","CORONEL RODOLFO S. DOMINGUEZ","0","2","0","2"
"2020-04-06","CORREA","0","2","0","2"
"2020-04-06","DESVIO ARIJON","0","1","0","1"
"2020-04-06","ELORTONDO","2","0","1","3"
"2020-04-06","EL RABON","0","1","0","1"
"2020-04-06","ESPERANZA","1","10","2","13"
"2020-04-06","FIGHIERA","0","1","0","1"
"2020-04-06","FIRMAT","1","3","0","4"
"2020-04-06","FLORENCIA","0","1","0","1"
"2020-04-06","FRANCK","1","4","0","5"
"2020-04-06","FRAY LUIS BELTRAN","0","5","0","5"
"2020-04-06","FUNES","3","14","1","18"
"2020-04-06","GABOTO","0","2","0","2"
"2020-04-06","GALVEZ","7","8","0","15"
"2020-04-06","GESSLER","0","0","1","1"
"2020-04-06","GOBERNADOR CRESPO","0","1","0","1"
"2020-04-06","GRANADERO BAIGORRIA","0","16","5","21"
"2020-04-06","HELVECIA","2","10","1","13"
"2020-04-06","HUMBOLDT","1","1","0","2"
"2020-04-06","IBARLUCEA","0","2","0","2"
"2020-04-06","JOSEFINA","0","2","0","2"
"2020-04-06","LA BRAVA","0","1","0","1"
"2020-04-06","LA CRIOLLA","0","1","0","1"
"2020-04-06","LAGUNA PAIVA","0","1","1","2"
"2020-04-06","LAS PAREJAS","1","0","0","1"
"2020-04-06","LAS ROSAS","0","1","0","1"
"2020-04-06","LAS TOSCAS","0","1","1","2"
"2020-04-06","LLAMBI CAMPBELL","3","0","0","3"
"2020-04-06","LOPEZ","0","1","0","1"
"2020-04-06","LOS QUIRQUINCHOS","0","1","0","1"
"2020-04-06","LUIS PALACIOS","0","1","0","1"
"2020-04-06","MACIEL","0","1","0","1"
"2020-04-06","MALABRIGO","0","1","1","2"
"2020-04-06","MARGARITA","0","1","0","1"
"2020-04-06","MONJE","0","1","0","1"
"2020-04-06","MONTE VERA","0","4","1","5"
"2020-04-06","OLIVEROS","0","3","1","4"
"2020-04-06","PAVON ARRIBA","0","1","0","1"
"2020-04-06","PEREZ","0","8","1","9"
"2020-04-06","PILAR","0","1","0","1"
"2020-04-06","PUEBLO ANDINO","2","0","0","2"
"2020-04-06","PUEBLO ESTHER","0","3","1","4"
"2020-04-06","PUERTO GENERAL SAN MARTIN","0","3","0","3"
"2020-04-06","PUERTO RECONQUISTA","0","1","0","1"
"2020-04-06","PUJATO","2","2","0","4"
"2020-04-06","RAFAELA","18","24","16","58"
"2020-04-06","RECONQUISTA","0","19","3","22"
"2020-04-06","RECREO","0","6","0","6"
"2020-04-06","RICARDONE","0","1","0","1"
"2020-04-06","ROLDAN","4","7","2","13"
"2020-04-06","ROSARIO","76","499","66","641"
"2020-04-06","RUFINO","0","1","0","1"
"2020-04-06","SALTO GRANDE","0","1","1","2"
"2020-04-06","SAN CARLOS CENTRO","0","6","0","6"
"2020-04-06","SAN CARLOS SUD","1","0","0","1"
"2020-04-06","SAN GENARO","1","1","0","2"
"2020-04-06","SAN JAVIER","1","3","0","4"
"2020-04-06","SAN JERONIMO NORTE","0","1","0","1"
"2020-04-06","SAN JERONIMO SUD","0","2","1","3"
"2020-04-06","SAN JORGE","0","4","0","4"
"2020-04-06","SAN JOSE DE LA ESQUINA","0","2","0","2"
"2020-04-06","SAN JOSE DEL RINCON","1","3","1","5"
"2020-04-06","SAN JUSTO","0","3","0","3"
"2020-04-06","SAN LORENZO","1","14","3","18"
"2020-04-06","SANTA FE","26","206","19","251"
"2020-04-06","SANTO TOME","5","31","0","36"
"2020-04-06","SARMIENTO","0","2","0","2"
"2020-04-06","SASTRE","0","1","0","1"
"2020-04-06","SAUCE VIEJO","1","9","1","11"
"2020-04-06","SERODINO","0","1","0","1"
"2020-04-06","SUARDI","0","2","0","2"
"2020-04-06","SUNCHALES","0","3","0","3"
"2020-04-06","TACURAL","0","2","0","2"
"2020-04-06","TIMBUES","0","2","1","3"
"2020-04-06","TOSTADO","0","1","0","1"
"2020-04-06","VENADO TUERTO","4","7","0","11"
"2020-04-06","VERA","1","4","1","6"
"2020-04-06","VILLA CONSTITUCION","8","9","1","18"
"2020-04-06","VILLA GOBERNADOR GALVEZ","2","24","3","29"
"2020-04-06","VILLA MUGUETA","0","1","0","1"
"2020-04-07","ALCORTA","0","1","0","1"
"2020-04-07","ALVAREZ","0","1","0","1"
"2020-04-07","ALVEAR","0","1","1","2"
"2020-04-07","ANGEL GALLARDO","0","2","0","2"
"2020-04-07","ARMSTRONG","2","2","0","4"
"2020-04-07","AROCENA","0","3","0","3"
"2020-04-07","ARROYO AGUIAR","0","1","0","1"
"2020-04-07","ARROYO LEYES","0","5","0","5"
"2020-04-07","ARROYO SECO","2","4","0","6"
"2020-04-07","AVELLANEDA","0","3","4","7"
"2020-04-07","BARRANCAS","0","1","0","1"
"2020-04-07","BIGAND","0","1","0","1"
"2020-04-07","BOMBAL","0","1","0","1"
"2020-04-07","CALCHAQUI","0","3","0","3"
"2020-04-07","CAÑADA DE GOMEZ","1","5","2","8"
"2020-04-07","CAÑADA DEL UCLE","0","1","0","1"
"2020-04-07","CAPITAN BERMUDEZ","0","7","1","8"
"2020-04-07","CARCARAÑA","0","5","2","7"
"2020-04-07","CARLOS PELLEGRINI","0","1","0","1"
"2020-04-07","CARMEN","0","1","0","1"
"2020-04-07","CARRERAS","0","2","0","2"
"2020-04-07","CARRIZALES","0","1","0","1"
"2020-04-07","CASILDA","2","11","8","21"
"2020-04-07","CAYASTA","0","2","0","2"
"2020-04-07","CERES","0","7","1","8"
"2020-04-07","CHABAS","1","2","0","3"
"2020-04-07","CLASON","0","0","1","1"
"2020-04-07","CORONDA","0","7","0","7"
"2020-04-07","CORONEL RODOLFO S. DOMINGUEZ","0","2","0","2"
"2020-04-07","CORREA","0","2","0","2"
"2020-04-07","DESVIO ARIJON","0","1","0","1"
"2020-04-07","ELORTONDO","2","0","1","3"
"2020-04-07","EL RABON","0","1","0","1"
"2020-04-07","ESPERANZA","1","11","2","14"
"2020-04-07","FIGHIERA","0","1","0","1"
"2020-04-07","FIRMAT","1","3","0","4"
"2020-04-07","FLORENCIA","0","1","0","1"
"2020-04-07","FRANCK","1","4","0","5"
"2020-04-07","FRAY LUIS BELTRAN","0","5","0","5"
"2020-04-07","FRONTERA","0","0","1","1"
"2020-04-07","FUNES","3","14","1","18"
"2020-04-07","GABOTO","0","2","0","2"
"2020-04-07","GALVEZ","7","8","2","17"
"2020-04-07","GESSLER","0","0","1","1"
"2020-04-07","GOBERNADOR CRESPO","0","1","0","1"
"2020-04-07","GRANADERO BAIGORRIA","1","17","7","25"
"2020-04-07","HELVECIA","2","10","1","13"
"2020-04-07","HUMBERTO PRIMO","0","0","1","1"
"2020-04-07","HUMBOLDT","1","1","0","2"
"2020-04-07","IBARLUCEA","0","2","0","2"
"2020-04-07","JOSEFINA","0","2","0","2"
"2020-04-07","LA BRAVA","0","1","0","1"
"2020-04-07","LA CRIOLLA","0","1","0","1"
"2020-04-07","LAGUNA PAIVA","0","2","0","2"
"2020-04-07","LAS PAREJAS","1","0","0","1"
"2020-04-07","LAS ROSAS","1","1","0","2"
"2020-04-07","LAS TOSCAS","0","2","0","2"
"2020-04-07","LLAMBI CAMPBELL","3","0","0","3"
"2020-04-07","LOPEZ","0","1","0","1"
"2020-04-07","LOS QUIRQUINCHOS","0","1","0","1"
"2020-04-07","LUIS PALACIOS","0","1","0","1"
"2020-04-07","MACIEL","0","1","0","1"
"2020-04-07","MALABRIGO","0","1","1","2"
"2020-04-07","MARGARITA","0","1","0","1"
"2020-04-07","MONJE","0","1","0","1"
"2020-04-07","MONTE VERA","0","4","1","5"
"2020-04-07","OLIVEROS","0","3","1","4"
"2020-04-07","PAVON ARRIBA","0","1","0","1"
"2020-04-07","PEREZ","0","8","2","10"
"2020-04-07","PILAR","0","1","0","1"
"2020-04-07","PUEBLO ANDINO","2","0","0","2"
"2020-04-07","PUEBLO ESTHER","0","4","0","4"
"2020-04-07","PUERTO GENERAL SAN MARTIN","0","3","2","5"
"2020-04-07","PUERTO RECONQUISTA","0","1","0","1"
"2020-04-07","PUJATO","2","2","0","4"
"2020-04-07","RAFAELA","18","35","10","63"
"2020-04-07","RECONQUISTA","0","19","3","22"
"2020-04-07","RECREO","0","7","0","7"
"2020-04-07","RICARDONE","0","1","1","2"
"2020-04-07","ROLDAN","4","7","2","13"
"2020-04-07","ROSARIO","77","559","97","733"
"2020-04-07","RUFINO","0","1","1","2"
"2020-04-07","SALTO GRANDE","0","1","1","2"
"2020-04-07","SAN CARLOS CENTRO","0","6","0","6"
"2020-04-07","SAN CARLOS SUD","1","0","0","1"
"2020-04-07","SAN GENARO","1","1","0","2"
"2020-04-07","SAN JAVIER","1","3","0","4"
"2020-04-07","SAN JERONIMO NORTE","0","1","0","1"
"2020-04-07","SAN JERONIMO SUD","0","2","1","3"
"2020-04-07","SAN JORGE","0","4","1","5"
"2020-04-07","SAN JOSE DE LA ESQUINA","0","2","0","2"
"2020-04-07","SAN JOSE DEL RINCON","1","3","1","5"
"2020-04-07","SAN JUSTO","0","3","1","4"
"2020-04-07","SAN LORENZO","1","15","6","22"
"2020-04-07","SANTA FE","26","212","33","271"
"2020-04-07","SANTA ISABEL","0","0","1","1"
"2020-04-07","SANTO TOME","5","31","1","37"
"2020-04-07","SARMIENTO","0","2","0","2"
"2020-04-07","SASTRE","0","1","0","1"
"2020-04-07","SAUCE VIEJO","1","10","1","12"
"2020-04-07","SERODINO","0","1","0","1"
"2020-04-07","SOLDINI","0","0","1","1"
"2020-04-07","SUARDI","0","2","0","2"
"2020-04-07","SUNCHALES","0","3","0","3"
"2020-04-07","TACURAL","0","2","0","2"
"2020-04-07","TIMBUES","0","2","1","3"
"2020-04-07","TOSTADO","0","1","0","1"
"2020-04-07","VENADO TUERTO","4","7","4","15"
"2020-04-07","VERA","1","5","0","6"
"2020-04-07","VILLA CONSTITUCION","8","9","1","18"
"2020-04-07","VILLA GOBERNADOR GALVEZ","2","24","4","30"
"2020-04-07","VILLA MUGUETA","0","1","1","2"
"2020-04-08","ALCORTA","0","1","0","1"
"2020-04-08","ALVAREZ","0","1","0","1"
"2020-04-08","ALVEAR","0","2","0","2"
"2020-04-08","ANGEL GALLARDO","0","2","0","2"
"2020-04-08","ARMSTRONG","2","2","0","4"
"2020-04-08","AROCENA","0","3","0","3"
"2020-04-08","ARROYO AGUIAR","0","1","0","1"
"2020-04-08","ARROYO LEYES","0","5","0","5"
"2020-04-08","ARROYO SECO","2","7","1","10"
"2020-04-08","ARRUFO","0","0","1","1"
"2020-04-08","AVELLANEDA","0","6","0","6"
"2020-04-08","BARRANCAS","0","1","0","1"
"2020-04-08","BIGAND","0","2","0","2"
"2020-04-08","BOMBAL","0","1","0","1"
"2020-04-08","CALCHAQUI","0","3","0","3"
"2020-04-08","CAÑADA DE GOMEZ","1","8","0","9"
"2020-04-08","CAÑADA DEL UCLE","0","1","0","1"
"2020-04-08","CAPITAN BERMUDEZ","0","9","1","10"
"2020-04-08","CARCARAÑA","0","6","1","7"
"2020-04-08","CARLOS PELLEGRINI","0","1","0","1"
"2020-04-08","CARMEN","0","1","0","1"
"2020-04-08","CARRERAS","0","2","0","2"
"2020-04-08","CARRIZALES","0","1","0","1"
"2020-04-08","CASILDA","2","15","4","21"
"2020-04-08","CAYASTA","0","2","0","2"
"2020-04-08","CERES","0","8","1","9"
"2020-04-08","CHABAS","1","2","0","3"
"2020-04-08","CLASON","0","1","0","1"
"2020-04-08","CORONDA","0","7","0","7"
"2020-04-08","CORONEL RODOLFO S. DOMINGUEZ","0","2","0","2"
"2020-04-08","CORREA","0","2","0","2"
"2020-04-08","DESVIO ARIJON","0","1","0","1"
"2020-04-08","ELORTONDO","2","0","3","5"
"2020-04-08","EL RABON","0","1","0","1"
"2020-04-08","ESPERANZA","1","11","3","15"
"2020-04-08","FIGHIERA","0","1","0","1"
"2020-04-08","FIRMAT","1","4","0","5"
"2020-04-08","FLORENCIA","0","1","0","1"
"2020-04-08","FRANCK","1","4","0","5"
"2020-04-08","FRAY LUIS BELTRAN","0","5","0","5"
"2020-04-08","FRONTERA","0","1","0","1"
"2020-04-08","FUNES","3","15","1","19"
"2020-04-08","GABOTO","0","2","0","2"
"2020-04-08","GALVEZ","7","8","2","17"
"2020-04-08","GESSLER","0","0","1","1"
"2020-04-08","GOBERNADOR CRESPO","0","1","0","1"
"2020-04-08","GRANADERO BAIGORRIA","1","21","4","26"
"2020-04-08","HELVECIA","2","10","1","13"
"2020-04-08","HUMBERTO PRIMO","0","1","0","1"
"2020-04-08","HUMBOLDT","1","1","0","2"
"2020-04-08","IBARLUCEA","0","2","0","2"
"2020-04-08","JOSEFINA","0","2","0","2"
"2020-04-08","LA BRAVA","0","1","0","1"
"2020-04-08","LA CRIOLLA","0","1","0","1"
"2020-04-08","LAGUNA PAIVA","0","2","0","2"
"2020-04-08","LAS PAREJAS","1","0","1","2"
"2020-04-08","LAS ROSAS","1","1","0","2"
"2020-04-08","LAS TOSCAS","0","2","0","2"
"2020-04-08","LLAMBI CAMPBELL","3","0","0","3"
"2020-04-08","LOPEZ","0","1","1","2"
"2020-04-08","LOS QUIRQUINCHOS","0","1","0","1"
"2020-04-08","LUIS PALACIOS","0","1","0","1"
"2020-04-08","MACIEL","0","1","0","1"
"2020-04-08","MALABRIGO","0","1","0","1"
"2020-04-08","MARGARITA","0","1","0","1"
"2020-04-08","MARIA JUANA","0","0","1","1"
"2020-04-08","MARIA TERESA","0","1","0","1"
"2020-04-08","MONJE","0","1","0","1"
"2020-04-08","MONTE VERA","0","4","1","5"
"2020-04-08","NELSON","0","0","1","1"
"2020-04-08","OLIVEROS","0","4","0","4"
"2020-04-08","PAVON ARRIBA","0","1","0","1"
"2020-04-08","PEREZ","0","12","2","14"
"2020-04-08","PILAR","0","1","0","1"
"2020-04-08","PUEBLO ANDINO","2","0","0","2"
"2020-04-08","PUEBLO ESTHER","0","4","0","4"
"2020-04-08","PUERTO GENERAL SAN MARTIN","0","7","0","7"
"2020-04-08","PUERTO RECONQUISTA","0","1","0","1"
"2020-04-08","PUJATO","2","2","0","4"
"2020-04-08","RAFAELA","18","35","11","64"
"2020-04-08","RECONQUISTA","0","21","1","22"
"2020-04-08","RECREO","0","7","1","8"
"2020-04-08","RICARDONE","0","2","0","2"
"2020-04-08","ROLDAN","4","8","4","16"
"2020-04-08","ROSARIO","79","682","49","810"
"2020-04-08","RUFINO","0","2","0","2"
"2020-04-08","SALTO GRANDE","0","2","0","2"
"2020-04-08","SAN ANTONIO DE OBLIGADO","0","1","0","1"
"2020-04-08","SAN CARLOS CENTRO","0","6","0","6"
"2020-04-08","SAN CARLOS SUD","1","0","0","1"
"2020-04-08","SAN GENARO","1","1","0","2"
"2020-04-08","SAN JAVIER","1","3","0","4"
"2020-04-08","SAN JERONIMO NORTE","0","1","0","1"
"2020-04-08","SAN JERONIMO SUD","0","2","1","3"
"2020-04-08","SAN JORGE","0","4","1","5"
"2020-04-08","SAN JOSE DE LA ESQUINA","0","2","0","2"
"2020-04-08","SAN JOSE DEL RINCON","1","3","2","6"
"2020-04-08","SAN JUSTO","0","3","1","4"
"2020-04-08","SAN LORENZO","1","19","3","23"
"2020-04-08","SANTA FE","26","234","32","292"
"2020-04-08","SANTA ISABEL","0","1","1","2"
"2020-04-08","SANTO DOMINGO","0","0","1","1"
"2020-04-08","SANTO TOME","5","32","2","39"
"2020-04-08","SARMIENTO","0","2","0","2"
"2020-04-08","SASTRE","0","1","0","1"
"2020-04-08","SAUCE VIEJO","1","11","0","12"
"2020-04-08","SERODINO","0","1","0","1"
"2020-04-08","SOLDINI","0","1","0","1"
"2020-04-08","SUARDI","0","2","0","2"
"2020-04-08","SUNCHALES","0","3","0","3"
"2020-04-08","TACURAL","0","2","0","2"
"2020-04-08","TIMBUES","0","2","1","3"
"2020-04-08","TOSTADO","0","1","0","1"
"2020-04-08","VENADO TUERTO","4","12","6","22"
"2020-04-08","VERA","1","5","0","6"
"2020-04-08","VILLA CONSTITUCION","8","9","2","19"
"2020-04-08","VILLA GOBERNADOR GALVEZ","2","30","4","36"
"2020-04-08","VILLA MUGUETA","0","2","0","2"
"2020-04-08","VILLA OCAMPO","0","0","1","1"
"2020-04-09","ALCORTA","0","1","0","1"
"2020-04-09","ALVAREZ","0","1","0","1"
"2020-04-09","ALVEAR","0","2","0","2"
"2020-04-09","ANGEL GALLARDO","0","2","0","2"
"2020-04-09","ARMSTRONG","2","2","0","4"
"2020-04-09","AROCENA","0","3","0","3"
"2020-04-09","ARROYO AGUIAR","0","1","0","1"
"2020-04-09","ARROYO LEYES","0","5","0","5"
"2020-04-09","ARROYO SECO","2","8","1","11"
"2020-04-09","ARRUFO","0","0","1","1"
"2020-04-09","AVELLANEDA","0","6","0","6"
"2020-04-09","BARRANCAS","0","1","0","1"
"2020-04-09","BIGAND","0","2","0","2"
"2020-04-09","BOMBAL","0","1","0","1"
"2020-04-09","CALCHAQUI","0","3","0","3"
"2020-04-09","CAÑADA DE GOMEZ","1","8","0","9"
"2020-04-09","CAÑADA DEL UCLE","0","1","0","1"
"2020-04-09","CAPITAN BERMUDEZ","0","10","1","11"
"2020-04-09","CARCARAÑA","0","7","0","7"
"2020-04-09","CARLOS PELLEGRINI","0","1","0","1"
"2020-04-09","CARMEN","0","1","0","1"
"2020-04-09","CARRERAS","0","2","0","2"
"2020-04-09","CARRIZALES","0","1","0","1"
"2020-04-09","CASILDA","2","15","4","21"
"2020-04-09","CAYASTA","0","2","0","2"
"2020-04-09","CERES","0","9","0","9"
"2020-04-09","CHABAS","1","2","0","3"
"2020-04-09","CLASON","0","1","0","1"
"2020-04-09","CORONDA","0","8","0","8"
"2020-04-09","CORONEL RODOLFO S. DOMINGUEZ","0","2","0","2"
"2020-04-09","CORREA","0","2","0","2"
"2020-04-09","DESVIO ARIJON","0","1","0","1"
"2020-04-09","ELORTONDO","4","2","1","7"
"2020-04-09","EL RABON","0","1","0","1"
"2020-04-09","ESPERANZA","1","13","1","15"
"2020-04-09","FIGHIERA","0","1","0","1"
"2020-04-09","FIRMAT","1","4","0","5"
"2020-04-09","FLORENCIA","0","1","1","2"
"2020-04-09","FRANCK","1","4","0","5"
"2020-04-09","FRAY LUIS BELTRAN","0","5","0","5"
"2020-04-09","FRONTERA","0","1","0","1"
"2020-04-09","FUNES","3","15","2","20"
"2020-04-09","GABOTO","0","2","0","2"
"2020-04-09","GALVEZ","9","8","1","18"
"2020-04-09","GESSLER","0","0","1","1"
"2020-04-09","GOBERNADOR CRESPO","0","1","0","1"
"2020-04-09","GRANADERO BAIGORRIA","1","22","4","27"
"2020-04-09","HELVECIA","2","11","1","14"
"2020-04-09","HUMBERTO PRIMO","0","1","0","1"
"2020-04-09","HUMBOLDT","1","1","0","2"
"2020-04-09","IBARLUCEA","0","2","0","2"
"2020-04-09","JOSEFINA","0","2","0","2"
"2020-04-09","LA BRAVA","0","1","0","1"
"2020-04-09","LA CRIOLLA","0","1","0","1"
"2020-04-09","LAGUNA PAIVA","0","2","0","2"
"2020-04-09","LAS PAREJAS","1","1","1","3"
"2020-04-09","LAS ROSAS","1","1","0","2"
"2020-04-09","LAS TOSCAS","0","2","0","2"
"2020-04-09","LLAMBI CAMPBELL","3","0","0","3"
"2020-04-09","LOPEZ","0","2","0","2"
"2020-04-09","LOS QUIRQUINCHOS","0","1","0","1"
"2020-04-09","LUIS PALACIOS","0","1","0","1"
"2020-04-09","MACIEL","0","1","0","1"
"2020-04-09","MALABRIGO","0","1","0","1"
"2020-04-09","MARGARITA","0","1","0","1"
"2020-04-09","MARIA JUANA","0","1","0","1"
"2020-04-09","MARIA SUSANA","0","0","1","1"
"2020-04-09","MARIA TERESA","0","1","0","1"
"2020-04-09","MONJE","0","1","0","1"
"2020-04-09","MONTE VERA","0","5","1","6"
"2020-04-09","NELSON","0","1","0","1"
"2020-04-09","OLIVEROS","1","3","0","4"
"2020-04-09","PAVON ARRIBA","0","1","0","1"
"2020-04-09","PEREZ","0","13","2","15"
"2020-04-09","PILAR","0","1","0","1"
"2020-04-09","PUEBLO ANDINO","2","0","0","2"
"2020-04-09","PUEBLO ESTHER","0","4","0","4"
"2020-04-09","PUERTO GENERAL SAN MARTIN","0","7","0","7"
"2020-04-09","PUERTO RECONQUISTA","0","1","0","1"
"2020-04-09","PUJATO","2","2","0","4"
"2020-04-09","RAFAELA","18","36","12","66"
"2020-04-09","RECONQUISTA","0","21","1","22"
"2020-04-09","RECREO","0","7","2","9"
"2020-04-09","RICARDONE","0","2","0","2"
"2020-04-09","RINCON POTRERO","0","1","0","1"
"2020-04-09","ROLDAN","4","9","4","17"
"2020-04-09","ROSARIO","79","718","88","885"
"2020-04-09","RUFINO","0","2","0","2"
"2020-04-09","SALTO GRANDE","0","2","0","2"
"2020-04-09","SAN ANTONIO DE OBLIGADO","0","1","0","1"
"2020-04-09","SAN CARLOS CENTRO","0","7","0","7"
"2020-04-09","SAN CARLOS SUD","1","0","0","1"
"2020-04-09","SAN GENARO","1","1","0","2"
"2020-04-09","SAN JAVIER","1","3","0","4"
"2020-04-09","SAN JERONIMO NORTE","0","2","0","2"
"2020-04-09","SAN JERONIMO SUD","0","2","1","3"
"2020-04-09","SAN JORGE","0","4","1","5"
"2020-04-09","SAN JOSE DE LA ESQUINA","0","2","0","2"
"2020-04-09","SAN JOSE DEL RINCON","1","4","1","6"
"2020-04-09","SAN JUSTO","0","4","0","4"
"2020-04-09","SAN LORENZO","1","19","6","26"
"2020-04-09","SANTA FE","27","270","20","317"
"2020-04-09","SANTA ISABEL","0","1","1","2"
"2020-04-09","SANTO DOMINGO","0","1","0","1"
"2020-04-09","SANTO TOME","5","38","0","43"
"2020-04-09","SARMIENTO","0","2","0","2"
"2020-04-09","SASTRE","0","1","0","1"
"2020-04-09","SAUCE VIEJO","1","12","0","13"
"2020-04-09","SERODINO","0","1","0","1"
"2020-04-09","SOLDINI","0","1","0","1"
"2020-04-09","SUARDI","0","2","0","2"
"2020-04-09","SUNCHALES","0","3","0","3"
"2020-04-09","TACURAL","0","2","0","2"
"2020-04-09","TIMBUES","0","2","1","3"
"2020-04-09","TOSTADO","0","1","2","3"
"2020-04-09","VENADO TUERTO","5","15","3","23"
"2020-04-09","VERA","1","5","0","6"
"2020-04-09","VILLA CONSTITUCION","8","11","0","19"
"2020-04-09","VILLA GOBERNADOR GALVEZ","2","30","5","37"
"2020-04-09","VILLA MUGUETA","0","2","0","2"
"2020-04-09","VILLA OCAMPO","0","1","0","1"
"2020-04-10","ALCORTA","0","1","1","2"
"2020-04-10","ALVAREZ","0","1","0","1"
"2020-04-10","ALVEAR","0","2","0","2"
"2020-04-10","ANGEL GALLARDO","0","2","1","3"
"2020-04-10","ARMSTRONG","2","2","0","4"
"2020-04-10","AROCENA","0","3","0","3"
"2020-04-10","ARROYO AGUIAR","0","1","0","1"
"2020-04-10","ARROYO LEYES","0","5","0","5"
"2020-04-10","ARROYO SECO","2","11","0","13"
"2020-04-10","ARRUFO","0","1","0","1"
"2020-04-10","AVELLANEDA","0","6","0","6"
"2020-04-10","BARRANCAS","0","1","0","1"
"2020-04-10","BIGAND","0","2","0","2"
"2020-04-10","BOMBAL","0","1","0","1"
"2020-04-10","CAFFERATA","0","1","0","1"
"2020-04-10","CALCHAQUI","0","3","0","3"
"2020-04-10","CAÑADA DE GOMEZ","1","9","0","10"
"2020-04-10","CAÑADA DEL UCLE","0","1","0","1"
"2020-04-10","CAPITAN BERMUDEZ","0","11","1","12"
"2020-04-10","CARCARAÑA","0","7","0","7"
"2020-04-10","CARLOS PELLEGRINI","0","1","0","1"
"2020-04-10","CARMEN","0","1","0","1"
"2020-04-10","CARRERAS","0","2","0","2"
"2020-04-10","CARRIZALES","0","1","0","1"
"2020-04-10","CASILDA","2","16","3","21"
"2020-04-10","CAYASTA","0","2","0","2"
"2020-04-10","CERES","0","9","1","10"
"2020-04-10","CHABAS","1","2","0","3"
"2020-04-10","CLASON","0","1","0","1"
"2020-04-10","CORONDA","0","8","1","9"
"2020-04-10","CORONEL RODOLFO S. DOMINGUEZ","0","2","0","2"
"2020-04-10","CORREA","0","2","0","2"
"2020-04-10","DESVIO ARIJON","0","1","0","1"
"2020-04-10","ELORTONDO","4","3","0","7"
"2020-04-10","EL RABON","0","1","0","1"
"2020-04-10","ESPERANZA","1","14","0","15"
"2020-04-10","FIGHIERA","0","1","0","1"
"2020-04-10","FIRMAT","1","4","0","5"
"2020-04-10","FLORENCIA","0","1","1","2"
"2020-04-10","FRANCK","1","4","0","5"
"2020-04-10","FRAY LUIS BELTRAN","0","5","0","5"
"2020-04-10","FRONTERA","0","1","0","1"
"2020-04-10","FUNES","3","15","2","20"
"2020-04-10","GABOTO","0","2","0","2"
"2020-04-10","GALVEZ","9","8","1","18"
"2020-04-10","GESSLER","0","0","1","1"
"2020-04-10","GOBERNADOR CRESPO","0","1","0","1"
"2020-04-10","GRANADERO BAIGORRIA","1","24","3","28"
"2020-04-10","HELVECIA","2","11","1","14"
"2020-04-10","HUMBERTO PRIMO","0","1","0","1"
"2020-04-10","HUMBOLDT","1","1","0","2"
"2020-04-10","IBARLUCEA","0","2","0","2"
"2020-04-10","JOSEFINA","0","2","0","2"
"2020-04-10","LA BRAVA","0","1","0","1"
"2020-04-10","LA CRIOLLA","0","1","0","1"
"2020-04-10","LAGUNA PAIVA","0","2","0","2"
"2020-04-10","LAS PAREJAS","1","2","0","3"
"2020-04-10","LAS ROSAS","1","1","0","2"
"2020-04-10","LAS TOSCAS","0","2","0","2"
"2020-04-10","LLAMBI CAMPBELL","3","0","0","3"
"2020-04-10","LOPEZ","0","2","0","2"
"2020-04-10","LOS QUIRQUINCHOS","0","1","0","1"
"2020-04-10","LUIS PALACIOS","0","1","0","1"
"2020-04-10","MACIEL","0","1","0","1"
"2020-04-10","MALABRIGO","0","1","0","1"
"2020-04-10","MARGARITA","0","1","0","1"
"2020-04-10","MARIA JUANA","0","1","0","1"
"2020-04-10","MARIA SUSANA","0","1","0","1"
"2020-04-10","MARIA TERESA","0","1","0","1"
"2020-04-10","MONJE","0","1","0","1"
"2020-04-10","MONTE VERA","0","5","1","6"
"2020-04-10","NELSON","0","1","0","1"
"2020-04-10","OLIVEROS","1","3","0","4"
"2020-04-10","PAVON ARRIBA","0","1","0","1"
"2020-04-10","PEREZ","0","14","3","17"
"2020-04-10","PILAR","0","1","0","1"
"2020-04-10","PUEBLO ANDINO","2","0","0","2"
"2020-04-10","PUEBLO ESTHER","0","5","0","5"
"2020-04-10","PUERTO GENERAL SAN MARTIN","0","7","0","7"
"2020-04-10","PUERTO RECONQUISTA","0","1","0","1"
"2020-04-10","PUJATO","2","2","0","4"
"2020-04-10","RAFAELA","18","44","7","69"
"2020-04-10","RECONQUISTA","0","21","1","22"
"2020-04-10","RECREO","0","9","0","9"
"2020-04-10","RICARDONE","0","2","0","2"
"2020-04-10","RINCON POTRERO","0","1","0","1"
"2020-04-10","ROLDAN","4","11","2","17"
"2020-04-10","ROSARIO","80","827","40","947"
"2020-04-10","RUFINO","0","2","0","2"
"2020-04-10","SALTO GRANDE","0","2","0","2"
"2020-04-10","SAN ANTONIO DE OBLIGADO","0","1","0","1"
"2020-04-10","SAN CARLOS CENTRO","0","7","0","7"
"2020-04-10","SAN CARLOS SUD","1","0","0","1"
"2020-04-10","SAN GENARO","1","1","0","2"
"2020-04-10","SAN GUILLERMO","0","0","1","1"
"2020-04-10","SAN JAVIER","1","3","0","4"
"2020-04-10","SAN JERONIMO NORTE","0","2","0","2"
"2020-04-10","SAN JERONIMO SUD","0","2","1","3"
"2020-04-10","SAN JORGE","0","5","0","5"
"2020-04-10","SAN JOSE DE LA ESQUINA","0","2","0","2"
"2020-04-10","SAN JOSE DEL RINCON","1","4","3","8"
"2020-04-10","SAN JUSTO","0","4","0","4"
"2020-04-10","SAN LORENZO","1","23","3","27"
"2020-04-10","SANTA CLARA DE BUENA VISTA","0","0","1","1"
"2020-04-10","SANTA FE","27","273","34","334"
"2020-04-10","SANTA ISABEL","0","1","1","2"
"2020-04-10","SANTO DOMINGO","0","1","0","1"
"2020-04-10","SANTO TOME","5","38","2","45"
"2020-04-10","SARMIENTO","0","2","0","2"
"2020-04-10","SASTRE","0","1","0","1"
"2020-04-10","SAUCE VIEJO","1","12","0","13"
"2020-04-10","SERODINO","0","1","0","1"
"2020-04-10","SOLDINI","0","1","0","1"
"2020-04-10","SUARDI","0","2","0","2"
"2020-04-10","SUNCHALES","0","3","0","3"
"2020-04-10","TACURAL","0","2","0","2"
"2020-04-10","TIMBUES","0","2","1","3"
"2020-04-10","TOSTADO","0","1","2","3"
"2020-04-10","VENADO TUERTO","5","15","4","24"
"2020-04-10","VERA","1","7","0","8"
"2020-04-10","VILLA CONSTITUCION","8","11","0","19"
"2020-04-10","VILLA GOBERNADOR GALVEZ","2","34","5","41"
"2020-04-10","VILLA MUGUETA","0","2","0","2"
"2020-04-10","VILLA OCAMPO","0","1","0","1"
"2020-04-11","ALCORTA","0","2","0","2"
"2020-04-11","ALVAREZ","0","1","0","1"
"2020-04-11","ALVEAR","0","2","0","2"
"2020-04-11","ANGEL GALLARDO","0","2","1","3"
"2020-04-11","ARMSTRONG","2","2","0","4"
"2020-04-11","AROCENA","0","3","0","3"
"2020-04-11","ARROYO AGUIAR","0","1","0","1"
"2020-04-11","ARROYO LEYES","0","5","1","6"
"2020-04-11","ARROYO SECO","2","11","0","13"
"2020-04-11","ARRUFO","0","1","0","1"
"2020-04-11","AVELLANEDA","0","6","0","6"
"2020-04-11","BARRANCAS","0","1","0","1"
"2020-04-11","BERNARDO DE IRIGOYEN","0","0","1","1"
"2020-04-11","BIGAND","0","3","0","3"
"2020-04-11","BOMBAL","0","1","0","1"
"2020-04-11","CAFFERATA","0","1","0","1"
"2020-04-11","CALCHAQUI","0","3","0","3"
"2020-04-11","CAÑADA DE GOMEZ","1","10","0","11"
"2020-04-11","CAÑADA DEL UCLE","0","1","0","1"
"2020-04-11","CAPITAN BERMUDEZ","0","12","0","12"
"2020-04-11","CARCARAÑA","0","7","0","7"
"2020-04-11","CARLOS PELLEGRINI","0","1","0","1"
"2020-04-11","CARMEN","0","1","0","1"
"2020-04-11","CARRERAS","0","2","1","3"
"2020-04-11","CARRIZALES","0","1","0","1"
"2020-04-11","CASILDA","2","19","2","23"
"2020-04-11","CAYASTA","0","2","0","2"
"2020-04-11","CERES","0","9","1","10"
"2020-04-11","CHABAS","1","2","0","3"
"2020-04-11","CHAÑAR LADEADO","0","1","0","1"
"2020-04-11","CLASON","0","1","0","1"
"2020-04-11","COLONIA ROSA","0","0","1","1"
"2020-04-11","CORONDA","0","8","2","10"
"2020-04-11","CORONEL RODOLFO S. DOMINGUEZ","0","2","0","2"
"2020-04-11","CORREA","0","3","0","3"
"2020-04-11","DESVIO ARIJON","0","1","0","1"
"2020-04-11","ELORTONDO","4","3","0","7"
"2020-04-11","EL RABON","0","1","0","1"
"2020-04-11","EL TREBOL","0","1","0","1"
"2020-04-11","ESPERANZA","1","14","1","16"
"2020-04-11","FIGHIERA","0","1","0","1"
"2020-04-11","FIRMAT","1","4","2","7"
"2020-04-11","FLORENCIA","0","2","0","2"
"2020-04-11","FRANCK","1","4","0","5"
"2020-04-11","FRAY LUIS BELTRAN","0","5","1","6"
"2020-04-11","FRONTERA","0","1","0","1"
"2020-04-11","FUNES","4","16","2","22"
"2020-04-11","GABOTO","0","2","0","2"
"2020-04-11","GALVEZ","9","8","1","18"
"2020-04-11","GESSLER","0","0","1","1"
"2020-04-11","GOBERNADOR CRESPO","0","1","0","1"
"2020-04-11","GRANADERO BAIGORRIA","1","27","4","32"
"2020-04-11","HELVECIA","2","11","1","14"
"2020-04-11","HUMBERTO PRIMO","0","1","0","1"
"2020-04-11","HUMBOLDT","1","1","0","2"
"2020-04-11","IBARLUCEA","0","2","0","2"
"2020-04-11","JOSEFINA","0","2","0","2"
"2020-04-11","LA BRAVA","0","1","0","1"
"2020-04-11","LA CRIOLLA","0","1","0","1"
"2020-04-11","LAGUNA PAIVA","0","2","0","2"
"2020-04-11","LAS PAREJAS","1","2","0","3"
"2020-04-11","LAS ROSAS","1","1","0","2"
"2020-04-11","LAS TOSCAS","0","2","0","2"
"2020-04-11","LLAMBI CAMPBELL","3","0","0","3"
"2020-04-11","LOPEZ","0","2","0","2"
"2020-04-11","LOS QUIRQUINCHOS","0","1","0","1"
"2020-04-11","LUIS PALACIOS","0","1","0","1"
"2020-04-11","MACIEL","0","1","0","1"
"2020-04-11","MALABRIGO","0","1","0","1"
"2020-04-11","MARGARITA","0","1","0","1"
"2020-04-11","MARIA JUANA","0","1","0","1"
"2020-04-11","MARIA SUSANA","0","1","0","1"
"2020-04-11","MARIA TERESA","0","1","0","1"
"2020-04-11","MONJE","0","1","0","1"
"2020-04-11","MONTE VERA","0","6","0","6"
"2020-04-11","NELSON","0","1","0","1"
"2020-04-11","OLIVEROS","1","3","0","4"
"2020-04-11","PAVON ARRIBA","0","1","0","1"
"2020-04-11","PEREZ","0","15","3","18"
"2020-04-11","PILAR","0","1","0","1"
"2020-04-11","PUEBLO ANDINO","2","0","0","2"
"2020-04-11","PUEBLO ESTHER","0","5","0","5"
"2020-04-11","PUERTO GENERAL SAN MARTIN","0","8","0","8"
"2020-04-11","PUERTO RECONQUISTA","0","1","0","1"
"2020-04-11","PUJATO","2","2","0","4"
"2020-04-11","RAFAELA","19","48","5","72"
"2020-04-11","RECONQUISTA","0","21","2","23"
"2020-04-11","RECREO","0","9","0","9"
"2020-04-11","RICARDONE","0","2","0","2"
"2020-04-11","RINCON POTRERO","0","1","0","1"
"2020-04-11","ROLDAN","4","11","2","17"
"2020-04-11","ROSARIO","81","860","51","992"
"2020-04-11","RUFINO","0","2","0","2"
"2020-04-11","SALTO GRANDE","0","2","0","2"
"2020-04-11","SAN ANTONIO DE OBLIGADO","0","1","0","1"
"2020-04-11","SAN CARLOS CENTRO","0","7","0","7"
"2020-04-11","SAN CARLOS SUD","1","0","0","1"
"2020-04-11","SAN GENARO","1","1","0","2"
"2020-04-11","SAN GUILLERMO","0","1","0","1"
"2020-04-11","SAN JAVIER","1","3","0","4"
"2020-04-11","SAN JERONIMO NORTE","0","2","0","2"
"2020-04-11","SAN JERONIMO SUD","0","2","1","3"
"2020-04-11","SAN JORGE","0","5","0","5"
"2020-04-11","SAN JOSE DE LA ESQUINA","0","3","0","3"
"2020-04-11","SAN JOSE DEL RINCON","1","4","3","8"
"2020-04-11","SAN JUSTO","0","4","0","4"
"2020-04-11","SAN LORENZO","1","23","3","27"
"2020-04-11","SANTA CLARA DE BUENA VISTA","0","1","0","1"
"2020-04-11","SANTA FE","27","279","57","363"
"2020-04-11","SANTA ISABEL","0","1","1","2"
"2020-04-11","SANTO DOMINGO","0","1","0","1"
"2020-04-11","SANTO TOME","5","38","7","50"
"2020-04-11","SARMIENTO","0","2","0","2"
"2020-04-11","SASTRE","0","1","1","2"
"2020-04-11","SAUCE VIEJO","1","13","0","14"
"2020-04-11","SERODINO","0","1","0","1"
"2020-04-11","SOLDINI","0","1","0","1"
"2020-04-11","SUARDI","0","2","0","2"
"2020-04-11","SUNCHALES","0","3","0","3"
"2020-04-11","TACURAL","0","2","0","2"
"2020-04-11","TIMBUES","0","2","1","3"
"2020-04-11","TOSTADO","0","3","0","3"
"2020-04-11","TOTORAS","0","0","1","1"
"2020-04-11","VENADO TUERTO","5","16","3","24"
"2020-04-11","VERA","1","7","5","13"
"2020-04-11","VILLA CONSTITUCION","8","11","0","19"
"2020-04-11","VILLA GOBERNADOR GALVEZ","2","39","2","43"
"2020-04-11","VILLA MUGUETA","0","2","0","2"
"2020-04-11","VILLA OCAMPO","0","1","0","1"
"2020-04-12","ALCORTA","0","2","0","2"
"2020-04-12","ALVAREZ","0","1","0","1"
"2020-04-12","ALVEAR","0","2","1","3"
"2020-04-12","ANGEL GALLARDO","0","3","0","3"
"2020-04-12","ARMSTRONG","2","3","0","5"
"2020-04-12","AROCENA","0","3","0","3"
"2020-04-12","ARROYO AGUIAR","0","1","0","1"
"2020-04-12","ARROYO LEYES","0","5","1","6"
"2020-04-12","ARROYO SECO","2","12","0","14"
"2020-04-12","ARRUFO","0","1","0","1"
"2020-04-12","AVELLANEDA","0","7","0","7"
"2020-04-12","BARRANCAS","0","1","0","1"
"2020-04-12","BERNARDO DE IRIGOYEN","0","0","1","1"
"2020-04-12","BIGAND","0","3","0","3"
"2020-04-12","BOMBAL","0","1","1","2"
"2020-04-12","BOUQUET","0","0","1","1"
"2020-04-12","CAFFERATA","0","1","0","1"
"2020-04-12","CALCHAQUI","0","3","0","3"
"2020-04-12","CAÑADA DE GOMEZ","1","10","2","13"
"2020-04-12","CAÑADA DEL UCLE","0","1","0","1"
"2020-04-12","CAPITAN BERMUDEZ","0","12","0","12"
"2020-04-12","CARCARAÑA","0","7","0","7"
"2020-04-12","CARLOS PELLEGRINI","0","1","0","1"
"2020-04-12","CARMEN","0","1","0","1"
"2020-04-12","CARRERAS","0","3","0","3"
"2020-04-12","CARRIZALES","0","1","0","1"
"2020-04-12","CASILDA","2","20","3","25"
"2020-04-12","CAYASTA","0","2","0","2"
"2020-04-12","CERES","0","9","1","10"
"2020-04-12","CHABAS","1","2","0","3"
"2020-04-12","CHAÑAR LADEADO","0","1","0","1"
"2020-04-12","CLASON","0","1","0","1"
"2020-04-12","COLONIA ROSA","0","1","0","1"
"2020-04-12","CORONDA","0","9","1","10"
"2020-04-12","CORONEL RODOLFO S. DOMINGUEZ","0","2","0","2"
"2020-04-12","CORREA","0","3","0","3"
"2020-04-12","DESVIO ARIJON","0","1","0","1"
"2020-04-12","ELORTONDO","4","3","0","7"
"2020-04-12","EL RABON","0","1","0","1"
"2020-04-12","EL TREBOL","0","1","0","1"
"2020-04-12","ESPERANZA","1","14","1","16"
"2020-04-12","FIGHIERA","0","1","0","1"
"2020-04-12","FIRMAT","1","6","0","7"
"2020-04-12","FLORENCIA","0","2","0","2"
"2020-04-12","FRANCK","1","4","0","5"
"2020-04-12","FRAY LUIS BELTRAN","0","7","0","7"
"2020-04-12","FRONTERA","0","1","0","1"
"2020-04-12","FUENTES","0","0","1","1"
"2020-04-12","FUNES","4","17","1","22"
"2020-04-12","GABOTO","0","2","0","2"
"2020-04-12","GALVEZ","9","9","1","19"
"2020-04-12","GESSLER","0","0","1","1"
"2020-04-12","GOBERNADOR CRESPO","0","1","0","1"
"2020-04-12","GRANADERO BAIGORRIA","1","28","5","34"
"2020-04-12","HELVECIA","2","11","1","14"
"2020-04-12","HUMBERTO PRIMO","0","1","0","1"
"2020-04-12","HUMBOLDT","1","1","0","2"
"2020-04-12","IBARLUCEA","0","2","0","2"
"2020-04-12","JOSEFINA","0","2","0","2"
"2020-04-12","LA BRAVA","0","1","0","1"
"2020-04-12","LA CRIOLLA","0","1","0","1"
"2020-04-12","LAGUNA PAIVA","0","2","0","2"
"2020-04-12","LAS PAREJAS","1","2","0","3"
"2020-04-12","LAS ROSAS","1","1","0","2"
"2020-04-12","LAS TOSCAS","0","2","0","2"
"2020-04-12","LLAMBI CAMPBELL","3","0","0","3"
"2020-04-12","LOPEZ","0","2","0","2"
"2020-04-12","LOS QUIRQUINCHOS","0","1","0","1"
"2020-04-12","LUIS PALACIOS","0","1","0","1"
"2020-04-12","MACIEL","0","1","0","1"
"2020-04-12","MALABRIGO","0","1","0","1"
"2020-04-12","MARGARITA","0","1","0","1"
"2020-04-12","MARIA JUANA","0","1","0","1"
"2020-04-12","MARIA SUSANA","0","1","0","1"
"2020-04-12","MARIA TERESA","0","1","0","1"
"2020-04-12","MONJE","0","1","0","1"
"2020-04-12","MONTE VERA","0","6","1","7"
"2020-04-12","NELSON","0","1","0","1"
"2020-04-12","OLIVEROS","1","3","0","4"
"2020-04-12","PAVON ARRIBA","0","1","0","1"
"2020-04-12","PEREZ","0","17","2","19"
"2020-04-12","PILAR","0","1","0","1"
"2020-04-12","PUEBLO ANDINO","2","0","0","2"
"2020-04-12","PUEBLO ESTHER","0","6","0","6"
"2020-04-12","PUERTO GENERAL SAN MARTIN","0","8","0","8"
"2020-04-12","PUERTO RECONQUISTA","0","1","0","1"
"2020-04-12","PUJATO","2","2","0","4"
"2020-04-12","RAFAELA","19","49","4","72"
"2020-04-12","RECONQUISTA","0","21","2","23"
"2020-04-12","RECREO","0","9","0","9"
"2020-04-12","RICARDONE","0","2","0","2"
"2020-04-12","RINCON POTRERO","0","1","0","1"
"2020-04-12","ROLDAN","4","11","2","17"
"2020-04-12","ROSARIO","84","910","36","1030"
"2020-04-12","RUFINO","0","2","0","2"
"2020-04-12","SALTO GRANDE","0","2","0","2"
"2020-04-12","SAN ANTONIO DE OBLIGADO","0","1","0","1"
"2020-04-12","SAN CARLOS CENTRO","0","7","0","7"
"2020-04-12","SAN CARLOS SUD","1","0","0","1"
"2020-04-12","SAN GENARO","1","1","0","2"
"2020-04-12","SAN GUILLERMO","0","1","0","1"
"2020-04-12","SAN JAVIER","1","3","0","4"
"2020-04-12","SAN JERONIMO NORTE","0","2","0","2"
"2020-04-12","SAN JERONIMO SUD","0","3","0","3"
"2020-04-12","SAN JORGE","0","5","0","5"
"2020-04-12","SAN JOSE DE LA ESQUINA","0","3","0","3"
"2020-04-12","SAN JOSE DEL RINCON","1","6","1","8"
"2020-04-12","SAN JUSTO","0","4","0","4"
"2020-04-12","SAN LORENZO","1","24","5","30"
"2020-04-12","SANTA CLARA DE BUENA VISTA","0","1","0","1"
"2020-04-12","SANTA FE","27","301","36","364"
"2020-04-12","SANTA ISABEL","0","1","1","2"
"2020-04-12","SANTO DOMINGO","0","1","0","1"
"2020-04-12","SANTO TOME","5","42","3","50"
"2020-04-12","SARMIENTO","0","2","0","2"
"2020-04-12","SASTRE","0","2","0","2"
"2020-04-12","SAUCE VIEJO","1","13","0","14"
"2020-04-12","SERODINO","0","1","0","1"
"2020-04-12","SOLDINI","0","1","0","1"
"2020-04-12","SUARDI","0","2","0","2"
"2020-04-12","SUNCHALES","0","3","0","3"
"2020-04-12","TACURAL","0","2","0","2"
"2020-04-12","TIMBUES","0","2","1","3"
"2020-04-12","TOSTADO","0","3","1","4"
"2020-04-12","TOTORAS","0","1","1","2"
"2020-04-12","VENADO TUERTO","5","17","3","25"
"2020-04-12","VERA","1","15","0","16"
"2020-04-12","VILLA CONSTITUCION","8","11","0","19"
"2020-04-12","VILLA GOBERNADOR GALVEZ","2","39","3","44"
"2020-04-12","VILLA MUGUETA","0","2","0","2"
"2020-04-12","VILLA OCAMPO","0","1","0","1"
"2020-04-13","ALCORTA","0","2","0","2"
"2020-04-13","ALVAREZ","0","1","0","1"
"2020-04-13","ALVEAR","0","3","0","3"
"2020-04-13","ANGEL GALLARDO","0","3","0","3"
"2020-04-13","ARMSTRONG","2","3","0","5"
"2020-04-13","AROCENA","0","3","0","3"
"2020-04-13","ARROYO AGUIAR","0","1","0","1"
"2020-04-13","ARROYO LEYES","0","5","1","6"
"2020-04-13","ARROYO SECO","2","13","0","15"
"2020-04-13","ARRUFO","0","2","0","2"
"2020-04-13","AVELLANEDA","0","7","0","7"
"2020-04-13","BARRANCAS","0","1","1","2"
"2020-04-13","BERNARDO DE IRIGOYEN","0","1","0","1"
"2020-04-13","BIGAND","0","3","0","3"
"2020-04-13","BOMBAL","0","2","0","2"
"2020-04-13","BOUQUET","0","1","0","1"
"2020-04-13","CAFFERATA","0","1","0","1"
"2020-04-13","CALCHAQUI","0","3","0","3"
"2020-04-13","CAÑADA DE GOMEZ","1","12","0","13"
"2020-04-13","CAÑADA DEL UCLE","0","1","0","1"
"2020-04-13","CAPITAN BERMUDEZ","0","12","1","13"
"2020-04-13","CARCARAÑA","0","7","0","7"
"2020-04-13","CARLOS PELLEGRINI","0","1","0","1"
"2020-04-13","CARMEN","0","1","0","1"
"2020-04-13","CARRERAS","0","3","0","3"
"2020-04-13","CARRIZALES","0","1","0","1"
"2020-04-13","CASILDA","2","23","1","26"
"2020-04-13","CAYASTA","0","2","1","3"
"2020-04-13","CERES","0","10","1","11"
"2020-04-13","CHABAS","1","2","0","3"
"2020-04-13","CHAÑAR LADEADO","0","1","0","1"
"2020-04-13","CLASON","0","1","0","1"
"2020-04-13","COLONIA ROSA","0","1","0","1"
"2020-04-13","CORONDA","0","10","0","10"
"2020-04-13","CORONEL RODOLFO S. DOMINGUEZ","0","2","0","2"
"2020-04-13","CORREA","0","3","0","3"
"2020-04-13","DESVIO ARIJON","0","1","0","1"
"2020-04-13","DIEGO DE ALVEAR","0","0","1","1"
"2020-04-13","ELORTONDO","4","3","0","7"
"2020-04-13","EL RABON","0","1","0","1"
"2020-04-13","EL TREBOL","0","1","0","1"
"2020-04-13","ESPERANZA","1","15","0","16"
"2020-04-13","FIGHIERA","0","2","0","2"
"2020-04-13","FIRMAT","1","6","0","7"
"2020-04-13","FLORENCIA","0","2","0","2"
"2020-04-13","FRANCK","1","4","1","6"
"2020-04-13","FRAY LUIS BELTRAN","0","7","0","7"
"2020-04-13","FRONTERA","0","1","0","1"
"2020-04-13","FUENTES","0","1","0","1"
"2020-04-13","FUNES","4","18","2","24"
"2020-04-13","GABOTO","0","2","0","2"
"2020-04-13","GALVEZ","9","9","1","19"
"2020-04-13","GENERAL LAGOS","0","0","1","1"
"2020-04-13","GESSLER","0","0","1","1"
"2020-04-13","GOBERNADOR CRESPO","0","1","0","1"
"2020-04-13","GRANADERO BAIGORRIA","1","35","2","38"
"2020-04-13","HELVECIA","2","11","1","14"
"2020-04-13","HUMBERTO PRIMO","0","1","0","1"
"2020-04-13","HUMBOLDT","1","1","0","2"
"2020-04-13","IBARLUCEA","0","2","0","2"
"2020-04-13","JOSEFINA","0","2","0","2"
"2020-04-13","LA BRAVA","0","1","0","1"
"2020-04-13","LA CRIOLLA","0","1","0","1"
"2020-04-13","LAGUNA PAIVA","0","2","0","2"
"2020-04-13","LAS PAREJAS","1","3","0","4"
"2020-04-13","LAS ROSAS","1","1","0","2"
"2020-04-13","LAS TOSCAS","0","2","0","2"
"2020-04-13","LLAMBI CAMPBELL","3","0","0","3"
"2020-04-13","LOPEZ","0","2","0","2"
"2020-04-13","LOS QUIRQUINCHOS","0","1","0","1"
"2020-04-13","LUIS PALACIOS","0","1","0","1"
"2020-04-13","MACIEL","0","1","1","2"
"2020-04-13","MALABRIGO","0","1","0","1"
"2020-04-13","MARGARITA","0","1","0","1"
"2020-04-13","MARIA JUANA","0","1","0","1"
"2020-04-13","MARIA SUSANA","0","1","0","1"
"2020-04-13","MARIA TERESA","0","1","0","1"
"2020-04-13","MONJE","0","1","0","1"
"2020-04-13","MONTE VERA","0","6","1","7"
"2020-04-13","NELSON","0","1","0","1"
"2020-04-13","OLIVEROS","1","3","0","4"
"2020-04-13","PAVON ARRIBA","0","1","0","1"
"2020-04-13","PEREZ","0","19","1","20"
"2020-04-13","PILAR","0","1","0","1"
"2020-04-13","PUEBLO ANDINO","2","0","0","2"
"2020-04-13","PUEBLO ESTHER","0","6","0","6"
"2020-04-13","PUEBLO IRIGOYEN","0","0","1","1"
"2020-04-13","PUERTO GENERAL SAN MARTIN","0","8","0","8"
"2020-04-13","PUERTO RECONQUISTA","0","1","0","1"
"2020-04-13","PUJATO","2","2","0","4"
"2020-04-13","RAFAELA","20","50","4","74"
"2020-04-13","RECONQUISTA","0","22","3","25"
"2020-04-13","RECREO","0","9","0","9"
"2020-04-13","RICARDONE","0","2","0","2"
"2020-04-13","RINCON POTRERO","0","1","0","1"
"2020-04-13","ROLDAN","4","12","1","17"
"2020-04-13","ROSARIO","85","969","33","1087"
"2020-04-13","RUFINO","0","2","0","2"
"2020-04-13","SALTO GRANDE","0","2","0","2"
"2020-04-13","SAN ANTONIO DE OBLIGADO","0","1","0","1"
"2020-04-13","SAN CARLOS CENTRO","0","7","0","7"
"2020-04-13","SAN CARLOS SUD","1","0","0","1"
"2020-04-13","SAN GENARO","1","1","0","2"
"2020-04-13","SAN GUILLERMO","0","1","0","1"
"2020-04-13","SAN JAVIER","1","3","0","4"
"2020-04-13","SAN JERONIMO NORTE","0","2","0","2"
"2020-04-13","SAN JERONIMO SUD","0","3","0","3"
"2020-04-13","SAN JORGE","0","5","1","6"
"2020-04-13","SAN JOSE DE LA ESQUINA","0","3","0","3"
"2020-04-13","SAN JOSE DEL RINCON","1","6","3","10"
"2020-04-13","SAN JUSTO","0","4","0","4"
"2020-04-13","SAN LORENZO","1","26","5","32"
"2020-04-13","SANTA CLARA DE BUENA VISTA","0","1","0","1"
"2020-04-13","SANTA FE","27","318","38","383"
"2020-04-13","SANTA ISABEL","0","1","1","2"
"2020-04-13","SANTO DOMINGO","0","1","0","1"
"2020-04-13","SANTO TOME","5","46","1","52"
"2020-04-13","SARMIENTO","0","2","0","2"
"2020-04-13","SASTRE","0","2","0","2"
"2020-04-13","SAUCE VIEJO","1","13","0","14"
"2020-04-13","SERODINO","0","1","0","1"
"2020-04-13","SOLDINI","0","1","0","1"
"2020-04-13","SOLEDAD","0","0","1","1"
"2020-04-13","SUARDI","0","2","0","2"
"2020-04-13","SUNCHALES","0","3","0","3"
"2020-04-13","SUSANA","0","0","1","1"
"2020-04-13","TACURAL","0","2","0","2"
"2020-04-13","TIMBUES","0","2","1","3"
"2020-04-13","TOSTADO","0","3","1","4"
"2020-04-13","TOTORAS","0","2","0","2"
"2020-04-13","VENADO TUERTO","5","19","3","27"
"2020-04-13","VERA","1","15","0","16"
"2020-04-13","VILLA CONSTITUCION","8","14","1","23"
"2020-04-13","VILLA GOBERNADOR GALVEZ","2","41","8","51"
"2020-04-13","VILLA MUGUETA","0","2","0","2"
"2020-04-13","VILLA OCAMPO","0","1","0","1"
"2020-04-14","ALCORTA","0","2","0","2"
"2020-04-14","ALVAREZ","0","1","0","1"
"2020-04-14","ALVEAR","0","3","0","3"
"2020-04-14","ANGEL GALLARDO","0","3","0","3"
"2020-04-14","ARMSTRONG","2","3","0","5"
"2020-04-14","AROCENA","0","3","1","4"
"2020-04-14","ARROYO AGUIAR","0","1","0","1"
"2020-04-14","ARROYO LEYES","0","5","1","6"
"2020-04-14","ARROYO SECO","2","13","0","15"
"2020-04-14","ARRUFO","0","2","0","2"
"2020-04-14","AVELLANEDA","0","7","1","8"
"2020-04-14","BARRANCAS","0","1","1","2"
"2020-04-14","BERNARDO DE IRIGOYEN","0","1","0","1"
"2020-04-14","BIGAND","0","3","1","4"
"2020-04-14","BOMBAL","0","2","0","2"
"2020-04-14","BOUQUET","0","1","0","1"
"2020-04-14","CAFFERATA","0","1","0","1"
"2020-04-14","CALCHAQUI","0","3","0","3"
"2020-04-14","CAÑADA DE GOMEZ","1","13","1","15"
"2020-04-14","CAÑADA DEL UCLE","0","1","0","1"
"2020-04-14","CAPITAN BERMUDEZ","0","13","1","14"
"2020-04-14","CARCARAÑA","0","7","0","7"
"2020-04-14","CARLOS PELLEGRINI","0","1","0","1"
"2020-04-14","CARMEN","0","1","0","1"
"2020-04-14","CARRERAS","0","3","0","3"
"2020-04-14","CARRIZALES","0","1","0","1"
"2020-04-14","CASILDA","2","23","1","26"
"2020-04-14","CAYASTA","0","2","1","3"
"2020-04-14","CERES","0","10","2","12"
"2020-04-14","CHABAS","1","2","0","3"
"2020-04-14","CHAÑAR LADEADO","0","1","0","1"
"2020-04-14","CLASON","0","1","0","1"
"2020-04-14","COLONIA ROSA","0","1","0","1"
"2020-04-14","CORONDA","0","10","0","10"
"2020-04-14","CORONEL RODOLFO S. DOMINGUEZ","0","2","0","2"
"2020-04-14","CORREA","0","3","0","3"
"2020-04-14","DESVIO ARIJON","0","1","0","1"
"2020-04-14","DIEGO DE ALVEAR","0","1","0","1"
"2020-04-14","ELORTONDO","4","3","0","7"
"2020-04-14","EL RABON","0","1","0","1"
"2020-04-14","EL TREBOL","0","1","0","1"
"2020-04-14","ESPERANZA","1","15","1","17"
"2020-04-14","FIGHIERA","0","2","0","2"
"2020-04-14","FIRMAT","1","6","0","7"
"2020-04-14","FLORENCIA","0","2","0","2"
"2020-04-14","FRANCK","1","4","1","6"
"2020-04-14","FRAY LUIS BELTRAN","0","7","0","7"
"2020-04-14","FRONTERA","0","1","0","1"
"2020-04-14","FUENTES","0","1","0","1"
"2020-04-14","FUNES","4","22","2","28"
"2020-04-14","GABOTO","0","2","0","2"
"2020-04-14","GALVEZ","9","10","2","21"
"2020-04-14","GENERAL LAGOS","0","1","0","1"
"2020-04-14","GESSLER","0","0","1","1"
"2020-04-14","GOBERNADOR CRESPO","0","1","0","1"
"2020-04-14","GRANADERO BAIGORRIA","1","37","1","39"
"2020-04-14","HELVECIA","2","11","2","15"
"2020-04-14","HUMBERTO PRIMO","0","1","0","1"
"2020-04-14","HUMBOLDT","1","1","0","2"
"2020-04-14","IBARLUCEA","0","2","0","2"
"2020-04-14","JOSEFINA","0","2","0","2"
"2020-04-14","LA BRAVA","0","1","0","1"
"2020-04-14","LA CRIOLLA","0","1","0","1"
"2020-04-14","LAGUNA PAIVA","0","2","0","2"
"2020-04-14","LAS PAREJAS","1","4","0","5"
"2020-04-14","LAS ROSAS","1","1","0","2"
"2020-04-14","LAS TOSCAS","0","2","0","2"
"2020-04-14","LLAMBI CAMPBELL","3","0","0","3"
"2020-04-14","LOPEZ","0","2","0","2"
"2020-04-14","LOS QUIRQUINCHOS","0","1","0","1"
"2020-04-14","LUIS PALACIOS","0","1","0","1"
"2020-04-14","MACIEL","0","2","0","2"
"2020-04-14","MALABRIGO","0","1","0","1"
"2020-04-14","MARGARITA","0","1","0","1"
"2020-04-14","MARIA JUANA","0","1","0","1"
"2020-04-14","MARIA SUSANA","0","1","0","1"
"2020-04-14","MARIA TERESA","0","1","0","1"
"2020-04-14","MONJE","0","1","0","1"
"2020-04-14","MONTE VERA","0","6","1","7"
"2020-04-14","NELSON","0","1","0","1"
"2020-04-14","OLIVEROS","2","4","0","6"
"2020-04-14","PAVON ARRIBA","0","1","0","1"
"2020-04-14","PEREZ","0","21","1","22"
"2020-04-14","PILAR","0","1","0","1"
"2020-04-14","PUEBLO ANDINO","2","0","0","2"
"2020-04-14","PUEBLO ESTHER","0","6","0","6"
"2020-04-14","PUEBLO IRIGOYEN","0","0","1","1"
"2020-04-14","PUERTO GENERAL SAN MARTIN","0","8","0","8"
"2020-04-14","PUERTO RECONQUISTA","0","1","0","1"
"2020-04-14","PUJATO","2","2","0","4"
"2020-04-14","RAFAELA","20","50","7","77"
"2020-04-14","RAMONA","0","0","1","1"
"2020-04-14","RECONQUISTA","0","22","4","26"
"2020-04-14","RECREO","0","9","0","9"
"2020-04-14","RICARDONE","0","2","0","2"
"2020-04-14","RINCON POTRERO","0","1","0","1"
"2020-04-14","ROLDAN","5","14","1","20"
"2020-04-14","ROMANG","0","0","1","1"
"2020-04-14","ROSARIO","85","1034","40","1159"
"2020-04-14","RUFINO","0","2","0","2"
"2020-04-14","SALTO GRANDE","0","2","0","2"
"2020-04-14","SAN ANTONIO DE OBLIGADO","0","1","0","1"
"2020-04-14","SAN CARLOS CENTRO","0","7","0","7"
"2020-04-14","SAN CARLOS SUD","1","0","0","1"
"2020-04-14","SAN GENARO","1","1","0","2"
"2020-04-14","SAN GUILLERMO","0","1","0","1"
"2020-04-14","SAN JAVIER","1","3","1","5"
"2020-04-14","SAN JERONIMO NORTE","0","2","0","2"
"2020-04-14","SAN JERONIMO SUD","0","3","0","3"
"2020-04-14","SAN JORGE","0","6","0","6"
"2020-04-14","SAN JOSE DE LA ESQUINA","0","3","1","4"
"2020-04-14","SAN JOSE DEL RINCON","1","7","2","10"
"2020-04-14","SAN JUSTO","0","4","0","4"
"2020-04-14","SAN LORENZO","1","28","4","33"
"2020-04-14","SANTA CLARA DE BUENA VISTA","0","1","0","1"
"2020-04-14","SANTA FE","27","324","46","397"
"2020-04-14","SANTA ISABEL","0","1","1","2"
"2020-04-14","SANTO DOMINGO","0","1","0","1"
"2020-04-14","SANTO TOME","5","47","3","55"
"2020-04-14","SARMIENTO","0","2","0","2"
"2020-04-14","SASTRE","0","2","0","2"
"2020-04-14","SAUCE VIEJO","1","13","0","14"
"2020-04-14","SERODINO","0","1","0","1"
"2020-04-14","SOLDINI","0","1","0","1"
"2020-04-14","SUARDI","0","2","0","2"
"2020-04-14","SUNCHALES","0","3","0","3"
"2020-04-14","SUSANA","0","0","1","1"
"2020-04-14","TACURAL","0","2","0","2"
"2020-04-14","TIMBUES","0","3","1","4"
"2020-04-14","TOSTADO","0","3","1","4"
"2020-04-14","TOTORAS","0","2","0","2"
"2020-04-14","VENADO TUERTO","5","21","3","29"
"2020-04-14","VERA","1","15","0","16"
"2020-04-14","VILLA CONSTITUCION","8","16","0","24"
"2020-04-14","VILLA GOBERNADOR GALVEZ","2","48","5","55"
"2020-04-14","VILLA MUGUETA","0","2","0","2"
"2020-04-14","VILLA OCAMPO","0","1","0","1"
"2020-04-14","ZAVALLA","0","1","0","1"
"2020-04-15","ALCORTA","0","2","0","2"
"2020-04-15","ALVAREZ","0","1","0","1"
"2020-04-15","ALVEAR","0","3","0","3"
"2020-04-15","ANGEL GALLARDO","0","3","0","3"
"2020-04-15","ARMSTRONG","2","3","0","5"
"2020-04-15","AROCENA","0","3","1","4"
"2020-04-15","ARROYO AGUIAR","0","1","0","1"
"2020-04-15","ARROYO LEYES","0","5","1","6"
"2020-04-15","ARROYO SECO","2","13","0","15"
"2020-04-15","ARRUFO","0","2","0","2"
"2020-04-15","AVELLANEDA","0","8","0","8"
"2020-04-15","BARRANCAS","0","2","0","2"
"2020-04-15","BERNARDO DE IRIGOYEN","0","1","0","1"
"2020-04-15","BIGAND","0","4","0","4"
"2020-04-15","BOMBAL","0","2","1","3"
"2020-04-15","BOUQUET","0","1","0","1"
"2020-04-15","CAFFERATA","0","1","0","1"
"2020-04-15","CALCHAQUI","0","3","0","3"
"2020-04-15","CAÑADA DE GOMEZ","1","14","0","15"
"2020-04-15","CAÑADA DEL UCLE","0","1","0","1"
"2020-04-15","CAPITAN BERMUDEZ","0","14","1","15"
"2020-04-15","CARCARAÑA","0","7","0","7"
"2020-04-15","CARLOS PELLEGRINI","0","1","0","1"
"2020-04-15","CARMEN","0","1","0","1"
"2020-04-15","CARRERAS","0","3","0","3"
"2020-04-15","CARRIZALES","0","1","0","1"
"2020-04-15","CASILDA","2","23","3","28"
"2020-04-15","CAYASTA","1","2","0","3"
"2020-04-15","CERES","0","11","1","12"
"2020-04-15","CHABAS","1","2","0","3"
"2020-04-15","CHAÑAR LADEADO","0","1","0","1"
"2020-04-15","CLASON","0","1","0","1"
"2020-04-15","COLONIA ROSA","0","1","0","1"
"2020-04-15","CORONDA","0","10","0","10"
"2020-04-15","CORONEL RODOLFO S. DOMINGUEZ","0","2","0","2"
"2020-04-15","CORREA","0","3","0","3"
"2020-04-15","DESVIO ARIJON","0","1","0","1"
"2020-04-15","DIEGO DE ALVEAR","0","1","0","1"
"2020-04-15","ELORTONDO","4","3","1","8"
"2020-04-15","EL RABON","0","1","0","1"
"2020-04-15","EL TREBOL","0","1","0","1"
"2020-04-15","ESPERANZA","1","15","2","18"
"2020-04-15","FIGHIERA","0","2","0","2"
"2020-04-15","FIRMAT","1","8","0","9"
"2020-04-15","FLORENCIA","0","2","0","2"
"2020-04-15","FRANCK","1","5","0","6"
"2020-04-15","FRAY LUIS BELTRAN","0","7","0","7"
"2020-04-15","FRONTERA","0","1","0","1"
"2020-04-15","FUENTES","0","1","1","2"
"2020-04-15","FUNES","4","23","1","28"
"2020-04-15","GABOTO","0","2","0","2"
"2020-04-15","GALVEZ","9","10","3","22"
"2020-04-15","GENERAL LAGOS","0","1","0","1"
"2020-04-15","GESSLER","0","0","1","1"
"2020-04-15","GOBERNADOR CRESPO","0","1","0","1"
"2020-04-15","GRANADERO BAIGORRIA","1","38","0","39"
"2020-04-15","HELVECIA","2","12","2","16"
"2020-04-15","HUMBERTO PRIMO","0","1","0","1"
"2020-04-15","HUMBOLDT","1","1","0","2"
"2020-04-15","IBARLUCEA","0","2","0","2"
"2020-04-15","JOSEFINA","0","2","0","2"
"2020-04-15","LA BRAVA","0","1","0","1"
"2020-04-15","LA CRIOLLA","0","1","0","1"
"2020-04-15","LAGUNA PAIVA","0","2","1","3"
"2020-04-15","LAS PAREJAS","1","4","0","5"
"2020-04-15","LAS ROSAS","1","1","0","2"
"2020-04-15","LAS TOSCAS","0","2","0","2"
"2020-04-15","LEHMANN","0","0","1","1"
"2020-04-15","LLAMBI CAMPBELL","3","0","0","3"
"2020-04-15","LOPEZ","0","2","0","2"
"2020-04-15","LOS QUIRQUINCHOS","0","1","0","1"
"2020-04-15","LUIS PALACIOS","0","1","0","1"
"2020-04-15","MACIEL","0","2","0","2"
"2020-04-15","MALABRIGO","0","1","0","1"
"2020-04-15","MARGARITA","0","1","0","1"
"2020-04-15","MARIA JUANA","0","1","0","1"
"2020-04-15","MARIA SUSANA","0","1","0","1"
"2020-04-15","MARIA TERESA","0","1","0","1"
"2020-04-15","MONJE","0","1","0","1"
"2020-04-15","MONTE VERA","0","7","0","7"
"2020-04-15","MURPHY","0","1","0","1"
"2020-04-15","NELSON","0","1","0","1"
"2020-04-15","OLIVEROS","2","4","0","6"
"2020-04-15","PAVON ARRIBA","0","1","0","1"
"2020-04-15","PEREZ","0","22","2","24"
"2020-04-15","PILAR","0","1","0","1"
"2020-04-15","PRESIDENTE ROCA","0","0","1","1"
"2020-04-15","PUEBLO ANDINO","2","0","0","2"
"2020-04-15","PUEBLO ESTHER","0","6","0","6"
"2020-04-15","PUEBLO IRIGOYEN","0","1","0","1"
"2020-04-15","PUERTO GENERAL SAN MARTIN","0","8","1","9"
"2020-04-15","PUERTO RECONQUISTA","0","1","0","1"
"2020-04-15","PUJATO","2","2","0","4"
"2020-04-15","RAFAELA","20","52","9","81"
"2020-04-15","RAMONA","0","1","1","2"
"2020-04-15","RECONQUISTA","0","24","2","26"
"2020-04-15","RECREO","0","9","1","10"
"2020-04-15","RICARDONE","0","2","0","2"
"2020-04-15","RINCON POTRERO","0","1","0","1"
"2020-04-15","ROLDAN","5","14","1","20"
"2020-04-15","ROMANG","0","0","1","1"
"2020-04-15","ROSARIO","86","1089","32","1207"
"2020-04-15","RUFINO","0","2","0","2"
"2020-04-15","SALTO GRANDE","0","2","0","2"
"2020-04-15","SAN ANTONIO DE OBLIGADO","0","1","0","1"
"2020-04-15","SAN CARLOS CENTRO","0","7","0","7"
"2020-04-15","SAN CARLOS SUD","1","0","0","1"
"2020-04-15","SANFORD","0","1","0","1"
"2020-04-15","SAN GENARO","1","1","0","2"
"2020-04-15","SAN GUILLERMO","0","1","0","1"
"2020-04-15","SAN JAVIER","1","4","0","5"
"2020-04-15","SAN JERONIMO NORTE","0","2","0","2"
"2020-04-15","SAN JERONIMO SUD","0","3","0","3"
"2020-04-15","SAN JORGE","0","6","0","6"
"2020-04-15","SAN JOSE DE LA ESQUINA","0","4","0","4"
"2020-04-15","SAN JOSE DEL RINCON","1","7","2","10"
"2020-04-15","SAN JUSTO","0","4","0","4"
"2020-04-15","SAN LORENZO","1","29","4","34"
"2020-04-15","SANTA CLARA DE BUENA VISTA","0","1","0","1"
"2020-04-15","SANTA FE","27","344","38","409"
"2020-04-15","SANTA ISABEL","0","1","1","2"
"2020-04-15","SANTO DOMINGO","0","1","0","1"
"2020-04-15","SANTO TOME","5","48","6","59"
"2020-04-15","SARMIENTO","0","2","0","2"
"2020-04-15","SASTRE","0","2","0","2"
"2020-04-15","SAUCE VIEJO","1","13","0","14"
"2020-04-15","SERODINO","0","1","0","1"
"2020-04-15","SOLDINI","0","1","0","1"
"2020-04-15","SUARDI","0","2","0","2"
"2020-04-15","SUNCHALES","0","3","0","3"
"2020-04-15","SUSANA","0","0","1","1"
"2020-04-15","TACURAL","0","2","0","2"
"2020-04-15","TEODELINA","0","1","0","1"
"2020-04-15","TIMBUES","0","3","1","4"
"2020-04-15","TOSTADO","0","4","0","4"
"2020-04-15","TOTORAS","0","2","0","2"
"2020-04-15","VENADO TUERTO","5","23","4","32"
"2020-04-15","VERA","1","15","0","16"
"2020-04-15","VIDELA","0","0","1","1"
"2020-04-15","VILLA CONSTITUCION","8","16","1","25"
"2020-04-15","VILLA GOBERNADOR GALVEZ","2","52","2","56"
"2020-04-15","VILLA MUGUETA","0","2","1","3"
"2020-04-15","VILLA OCAMPO","0","1","0","1"
"2020-04-15","ZAVALLA","0","1","0","1"
"2020-04-16","ALCORTA","0","2","0","2"
"2020-04-16","ALVAREZ","0","1","0","1"
"2020-04-16","ALVEAR","0","3","0","3"
"2020-04-16","ANGEL GALLARDO","0","3","0","3"
"2020-04-16","ARMSTRONG","2","4","1","7"
"2020-04-16","AROCENA","0","4","0","4"
"2020-04-16","ARROYO AGUIAR","0","1","0","1"
"2020-04-16","ARROYO LEYES","0","6","0","6"
"2020-04-16","ARROYO SECO","2","15","0","17"
"2020-04-16","ARRUFO","0","2","0","2"
"2020-04-16","AVELLANEDA","0","8","0","8"
"2020-04-16","BARRANCAS","0","2","0","2"
"2020-04-16","BERNARDO DE IRIGOYEN","0","1","0","1"
"2020-04-16","BIGAND","0","4","0","4"
"2020-04-16","BOMBAL","0","3","0","3"
"2020-04-16","BOUQUET","0","1","0","1"
"2020-04-16","CAFFERATA","0","1","0","1"
"2020-04-16","CALCHAQUI","0","3","0","3"
"2020-04-16","CAÑADA DE GOMEZ","1","15","0","16"
"2020-04-16","CAÑADA DEL UCLE","0","1","0","1"
"2020-04-16","CAPITAN BERMUDEZ","0","16","0","16"
"2020-04-16","CARCARAÑA","0","7","0","7"
"2020-04-16","CARLOS PELLEGRINI","0","1","0","1"
"2020-04-16","CARMEN","0","1","0","1"
"2020-04-16","CARRERAS","0","3","0","3"
"2020-04-16","CARRIZALES","0","1","0","1"
"2020-04-16","CASILDA","2","26","1","29"
"2020-04-16","CAYASTA","1","2","2","5"
"2020-04-16","CERES","0","11","1","12"
"2020-04-16","CHABAS","1","2","0","3"
"2020-04-16","CHAÑAR LADEADO","0","1","0","1"
"2020-04-16","CLASON","0","1","0","1"
"2020-04-16","COLONIA ROSA","0","1","0","1"
"2020-04-16","CORONDA","0","10","0","10"
"2020-04-16","CORONEL RODOLFO S. DOMINGUEZ","0","2","0","2"
"2020-04-16","CORREA","0","3","0","3"
"2020-04-16","DESVIO ARIJON","0","1","0","1"
"2020-04-16","DIEGO DE ALVEAR","0","1","0","1"
"2020-04-16","ELORTONDO","4","3","1","8"
"2020-04-16","EL RABON","0","1","0","1"
"2020-04-16","EL TREBOL","0","1","0","1"
"2020-04-16","ESPERANZA","1","16","3","20"
"2020-04-16","FIGHIERA","0","2","0","2"
"2020-04-16","FIRMAT","1","8","2","11"
"2020-04-16","FLORENCIA","0","2","0","2"
"2020-04-16","FRANCK","1","5","0","6"
"2020-04-16","FRAY LUIS BELTRAN","0","8","0","8"
"2020-04-16","FRONTERA","0","1","0","1"
"2020-04-16","FUENTES","0","1","1","2"
"2020-04-16","FUNES","4","23","1","28"
"2020-04-16","GABOTO","0","3","0","3"
"2020-04-16","GALVEZ","9","13","0","22"
"2020-04-16","GENERAL LAGOS","0","1","0","1"
"2020-04-16","GESSLER","0","0","1","1"
"2020-04-16","GOBERNADOR CRESPO","0","1","0","1"
"2020-04-16","GRANADERO BAIGORRIA","1","39","1","41"
"2020-04-16","HELVECIA","2","12","2","16"
"2020-04-16","HUMBERTO PRIMO","0","1","0","1"
"2020-04-16","HUMBOLDT","1","1","0","2"
"2020-04-16","IBARLUCEA","0","2","0","2"
"2020-04-16","JOSEFINA","0","2","0","2"
"2020-04-16","LA BRAVA","0","1","0","1"
"2020-04-16","LA CRIOLLA","0","1","0","1"
"2020-04-16","LAGUNA PAIVA","0","2","1","3"
"2020-04-16","LAS PAREJAS","1","4","0","5"
"2020-04-16","LAS ROSAS","1","1","1","3"
"2020-04-16","LAS TOSCAS","0","3","0","3"
"2020-04-16","LEHMANN","0","0","1","1"
"2020-04-16","LLAMBI CAMPBELL","3","0","1","4"
"2020-04-16","LOPEZ","0","2","0","2"
"2020-04-16","LOS QUIRQUINCHOS","0","1","0","1"
"2020-04-16","LUIS PALACIOS","0","1","0","1"
"2020-04-16","MACIEL","0","2","0","2"
"2020-04-16","MALABRIGO","0","1","0","1"
"2020-04-16","MARGARITA","0","1","1","2"
"2020-04-16","MARIA JUANA","0","1","0","1"
"2020-04-16","MARIA SUSANA","0","1","0","1"
"2020-04-16","MARIA TERESA","0","1","0","1"
"2020-04-16","MONJE","0","1","0","1"
"2020-04-16","MONTE VERA","0","7","0","7"
"2020-04-16","MURPHY","0","1","0","1"
"2020-04-16","NELSON","0","1","0","1"
"2020-04-16","OLIVEROS","2","4","0","6"
"2020-04-16","PAVON ARRIBA","0","1","0","1"
"2020-04-16","PEREZ","0","25","1","26"
"2020-04-16","PILAR","0","1","0","1"
"2020-04-16","PRESIDENTE ROCA","0","0","1","1"
"2020-04-16","PUEBLO ANDINO","2","1","0","3"
"2020-04-16","PUEBLO ESTHER","0","6","0","6"
"2020-04-16","PUEBLO IRIGOYEN","0","1","0","1"
"2020-04-16","PUERTO GENERAL SAN MARTIN","0","10","0","10"
"2020-04-16","PUERTO RECONQUISTA","0","1","0","1"
"2020-04-16","PUJATO","2","4","0","6"
"2020-04-16","RAFAELA","20","52","14","86"
"2020-04-16","RAMONA","0","1","1","2"
"2020-04-16","RECONQUISTA","0","24","2","26"
"2020-04-16","RECREO","0","9","1","10"
"2020-04-16","RICARDONE","0","2","1","3"
"2020-04-16","RINCON POTRERO","0","1","0","1"
"2020-04-16","ROLDAN","5","16","1","22"
"2020-04-16","ROMANG","0","1","0","1"
"2020-04-16","ROSARIO","88","1133","50","1271"
"2020-04-16","RUFINO","0","2","0","2"
"2020-04-16","SALTO GRANDE","0","2","0","2"
"2020-04-16","SAN ANTONIO DE OBLIGADO","0","1","0","1"
"2020-04-16","SAN CARLOS CENTRO","0","7","0","7"
"2020-04-16","SAN CARLOS SUD","1","0","0","1"
"2020-04-16","SANFORD","0","1","0","1"
"2020-04-16","SAN GENARO","1","1","0","2"
"2020-04-16","SAN GUILLERMO","0","1","0","1"
"2020-04-16","SAN JAVIER","1","4","0","5"
"2020-04-16","SAN JERONIMO DEL SAUCE","0","0","1","1"
"2020-04-16","SAN JERONIMO NORTE","0","2","0","2"
"2020-04-16","SAN JERONIMO SUD","0","3","0","3"
"2020-04-16","SAN JORGE","0","6","0","6"
"2020-04-16","SAN JOSE DE LA ESQUINA","0","4","0","4"
"2020-04-16","SAN JOSE DEL RINCON","1","9","1","11"
"2020-04-16","SAN JUSTO","0","4","1","5"
"2020-04-16","SAN LORENZO","1","30","5","36"
"2020-04-16","SANTA CLARA DE BUENA VISTA","0","1","0","1"
"2020-04-16","SANTA FE","27","361","33","421"
"2020-04-16","SANTA ISABEL","0","1","1","2"
"2020-04-16","SANTA ROSA DE CALCHINES","0","0","1","1"
"2020-04-16","SANTO DOMINGO","0","1","0","1"
"2020-04-16","SANTO TOME","5","51","4","60"
"2020-04-16","SARMIENTO","0","2","0","2"
"2020-04-16","SASTRE","0","2","0","2"
"2020-04-16","SAUCE VIEJO","1","13","0","14"
"2020-04-16","SERODINO","0","1","0","1"
"2020-04-16","SOLDINI","0","1","0","1"
"2020-04-16","SUARDI","0","2","0","2"
"2020-04-16","SUNCHALES","0","3","0","3"
"2020-04-16","SUSANA","0","1","0","1"
"2020-04-16","TACURAL","0","2","0","2"
"2020-04-16","TEODELINA","0","1","0","1"
"2020-04-16","TIMBUES","0","3","1","4"
"2020-04-16","TOSTADO","0","4","0","4"
"2020-04-16","TOTORAS","0","2","0","2"
"2020-04-16","VENADO TUERTO","5","24","5","34"
"2020-04-16","VERA","1","15","0","16"
"2020-04-16","VIDELA","0","0","1","1"
"2020-04-16","VILLA CAÑAS","0","1","0","1"
"2020-04-16","VILLA CONSTITUCION","9","17","0","26"
"2020-04-16","VILLA GOBERNADOR GALVEZ","2","55","2","59"
"2020-04-16","VILLA MUGUETA","0","3","0","3"
"2020-04-16","VILLA OCAMPO","0","1","0","1"
"2020-04-16","ZAVALLA","0","1","0","1"
"2020-04-17","ALCORTA","0","2","0","2"
"2020-04-17","ALVAREZ","0","1","0","1"
"2020-04-17","ALVEAR","0","3","0","3"
"2020-04-17","ANGEL GALLARDO","0","4","0","4"
"2020-04-17","ARMSTRONG","2","5","0","7"
"2020-04-17","AROCENA","0","4","0","4"
"2020-04-17","ARROYO AGUIAR","0","1","0","1"
"2020-04-17","ARROYO LEYES","0","6","0","6"
"2020-04-17","ARROYO SECO","2","15","1","18"
"2020-04-17","ARRUFO","0","2","0","2"
"2020-04-17","ARTEAGA","0","0","1","1"
"2020-04-17","AVELLANEDA","0","8","0","8"
"2020-04-17","BARRANCAS","0","2","1","3"
"2020-04-17","BERNARDO DE IRIGOYEN","0","1","0","1"
"2020-04-17","BIGAND","0","4","0","4"
"2020-04-17","BOMBAL","0","3","0","3"
"2020-04-17","BOUQUET","0","1","0","1"
"2020-04-17","CAFFERATA","0","1","0","1"
"2020-04-17","CALCHAQUI","0","3","0","3"
"2020-04-17","CAÑADA DE GOMEZ","1","17","2","20"
"2020-04-17","CAÑADA DEL UCLE","0","1","0","1"
"2020-04-17","CAPITAN BERMUDEZ","0","16","1","17"
"2020-04-17","CARCARAÑA","0","7","1","8"
"2020-04-17","CARLOS PELLEGRINI","0","1","0","1"
"2020-04-17","CARMEN","0","1","0","1"
"2020-04-17","CARRERAS","0","3","0","3"
"2020-04-17","CARRIZALES","0","1","0","1"
"2020-04-17","CASILDA","2","26","2","30"
"2020-04-17","CAYASTA","1","4","0","5"
"2020-04-17","CERES","0","13","0","13"
"2020-04-17","CHABAS","1","2","0","3"
"2020-04-17","CHAÑAR LADEADO","0","1","0","1"
"2020-04-17","CLASON","0","1","0","1"
"2020-04-17","COLONIA ROSA","0","1","0","1"
"2020-04-17","CORONDA","0","10","0","10"
"2020-04-17","CORONEL RODOLFO S. DOMINGUEZ","0","2","0","2"
"2020-04-17","CORREA","0","3","1","4"
"2020-04-17","DESVIO ARIJON","0","1","0","1"
"2020-04-17","DIEGO DE ALVEAR","0","1","0","1"
"2020-04-17","ELORTONDO","4","3","1","8"
"2020-04-17","EL RABON","0","1","0","1"
"2020-04-17","EL TREBOL","0","1","0","1"
"2020-04-17","EMPALME VILLA CONSTITUCION","0","0","1","1"
"2020-04-17","ESPERANZA","1","17","4","22"
"2020-04-17","FIGHIERA","0","2","0","2"
"2020-04-17","FIRMAT","1","10","0","11"
"2020-04-17","FLORENCIA","0","2","0","2"
"2020-04-17","FRANCK","1","5","2","8"
"2020-04-17","FRAY LUIS BELTRAN","0","8","0","8"
"2020-04-17","FRONTERA","0","1","0","1"
"2020-04-17","FUENTES","0","2","0","2"
"2020-04-17","FUNES","4","23","1","28"
"2020-04-17","GABOTO","0","3","0","3"
"2020-04-17","GALVEZ","9","14","1","24"
"2020-04-17","GENERAL LAGOS","0","1","0","1"
"2020-04-17","GESSLER","0","0","1","1"
"2020-04-17","GOBERNADOR CRESPO","0","1","0","1"
"2020-04-17","GODOY","0","0","1","1"
"2020-04-17","GRANADERO BAIGORRIA","1","41","0","42"
"2020-04-17","HELVECIA","2","13","1","16"
"2020-04-17","HUMBERTO PRIMO","0","1","0","1"
"2020-04-17","HUMBOLDT","1","1","0","2"
"2020-04-17","IBARLUCEA","0","3","0","3"
"2020-04-17","JOSEFINA","0","2","0","2"
"2020-04-17","LA BRAVA","0","1","0","1"
"2020-04-17","LA CRIOLLA","0","1","0","1"
"2020-04-17","LAGUNA PAIVA","0","3","0","3"
"2020-04-17","LANTERI","0","1","0","1"
"2020-04-17","LAS PAREJAS","1","4","0","5"
"2020-04-17","LAS ROSAS","1","3","0","4"
"2020-04-17","LAS TOSCAS","0","3","0","3"
"2020-04-17","LEHMANN","0","1","0","1"
"2020-04-17","LLAMBI CAMPBELL","3","1","0","4"
"2020-04-17","LOPEZ","0","2","0","2"
"2020-04-17","LOS QUIRQUINCHOS","0","1","0","1"
"2020-04-17","LUIS PALACIOS","0","1","0","1"
"2020-04-17","MACIEL","0","2","0","2"
"2020-04-17","MALABRIGO","0","1","0","1"
"2020-04-17","MARGARITA","0","2","0","2"
"2020-04-17","MARIA JUANA","0","1","0","1"
"2020-04-17","MARIA SUSANA","0","1","0","1"
"2020-04-17","MARIA TERESA","0","1","0","1"
"2020-04-17","MAXIMO PAZ","0","0","1","1"
"2020-04-17","MONJE","0","1","0","1"
"2020-04-17","MONTE VERA","0","7","0","7"
"2020-04-17","MURPHY","0","1","0","1"
"2020-04-17","NELSON","0","1","0","1"
"2020-04-17","OLIVEROS","2","4","0","6"
"2020-04-17","PAVON ARRIBA","0","1","0","1"
"2020-04-17","PEREZ","0","25","1","26"
"2020-04-17","PILAR","0","1","0","1"
"2020-04-17","PRESIDENTE ROCA","0","1","0","1"
"2020-04-17","PUEBLO ANDINO","2","1","0","3"
"2020-04-17","PUEBLO ESTHER","0","6","0","6"
"2020-04-17","PUEBLO IRIGOYEN","0","1","0","1"
"2020-04-17","PUERTO GENERAL SAN MARTIN","0","10","0","10"
"2020-04-17","PUERTO RECONQUISTA","0","1","0","1"
"2020-04-17","PUJATO","2","4","0","6"
"2020-04-17","RAFAELA","20","64","7","91"
"2020-04-17","RAMONA","0","2","0","2"
"2020-04-17","RECONQUISTA","0","26","1","27"
"2020-04-17","RECREO","0","10","1","11"
"2020-04-17","RICARDONE","0","3","0","3"
"2020-04-17","RINCON POTRERO","0","1","0","1"
"2020-04-17","ROLDAN","5","16","1","22"
"2020-04-17","ROMANG","0","1","0","1"
"2020-04-17","ROSARIO","94","1197","53","1344"
"2020-04-17","RUFINO","0","2","0","2"
"2020-04-17","SALTO GRANDE","0","2","0","2"
"2020-04-17","SAN ANTONIO DE OBLIGADO","0","1","0","1"
"2020-04-17","SAN CARLOS CENTRO","0","7","0","7"
"2020-04-17","SAN CARLOS SUD","1","0","0","1"
"2020-04-17","SAN CRISTOBAL","0","1","0","1"
"2020-04-17","SANFORD","0","1","0","1"
"2020-04-17","SAN GENARO","1","1","0","2"
"2020-04-17","SAN GUILLERMO","0","1","0","1"
"2020-04-17","SAN JAVIER","1","4","0","5"
"2020-04-17","SAN JERONIMO DEL SAUCE","0","0","1","1"
"2020-04-17","SAN JERONIMO NORTE","0","2","0","2"
"2020-04-17","SAN JERONIMO SUD","0","3","0","3"
"2020-04-17","SAN JORGE","0","6","1","7"
"2020-04-17","SAN JOSE DE LA ESQUINA","0","4","1","5"
"2020-04-17","SAN JOSE DEL RINCON","1","9","1","11"
"2020-04-17","SAN JUSTO","0","5","0","5"
"2020-04-17","SAN LORENZO","1","31","4","36"
"2020-04-17","SANTA CLARA DE BUENA VISTA","0","1","1","2"
"2020-04-17","SANTA FE","27","379","28","434"
"2020-04-17","SANTA ISABEL","0","1","1","2"
"2020-04-17","SANTA ROSA DE CALCHINES","0","0","1","1"
"2020-04-17","SANTO DOMINGO","0","1","0","1"
"2020-04-17","SANTO TOME","5","55","1","61"
"2020-04-17","SAN VICENTE","0","0","2","2"
"2020-04-17","SARMIENTO","0","2","0","2"
"2020-04-17","SASTRE","0","2","0","2"
"2020-04-17","SAUCE VIEJO","1","13","0","14"
"2020-04-17","SERODINO","0","1","0","1"
"2020-04-17","SOLDINI","0","1","0","1"
"2020-04-17","SUARDI","0","2","0","2"
"2020-04-17","SUNCHALES","0","3","0","3"
"2020-04-17","SUSANA","0","1","0","1"
"2020-04-17","TACURAL","0","2","0","2"
"2020-04-17","TEODELINA","0","1","0","1"
"2020-04-17","TIMBUES","0","3","1","4"
"2020-04-17","TOSTADO","0","4","0","4"
"2020-04-17","TOTORAS","0","2","0","2"
"2020-04-17","VENADO TUERTO","5","28","3","36"
"2020-04-17","VERA","1","15","0","16"
"2020-04-17","VIDELA","0","1","0","1"
"2020-04-17","VILLA CAÑAS","0","1","0","1"
"2020-04-17","VILLA CONSTITUCION","9","17","0","26"
"2020-04-17","VILLA GOBERNADOR GALVEZ","2","59","4","65"
"2020-04-17","VILLA MINETTI","0","1","0","1"
"2020-04-17","VILLA MUGUETA","0","3","0","3"
"2020-04-17","VILLA OCAMPO","0","1","0","1"
"2020-04-17","WHEELWRIGHT","0","1","0","1"
"2020-04-17","ZAVALLA","0","1","0","1"
"2020-04-18","ALCORTA","0","2","0","2"
"2020-04-18","ALVAREZ","0","1","0","1"
"2020-04-18","ALVEAR","0","3","0","3"
"2020-04-18","ANGEL GALLARDO","0","4","0","4"
"2020-04-18","ARMSTRONG","2","5","1","8"
"2020-04-18","AROCENA","0","4","0","4"
"2020-04-18","ARROYO AGUIAR","0","1","0","1"
"2020-04-18","ARROYO LEYES","0","6","0","6"
"2020-04-18","ARROYO SECO","2","16","1","19"
"2020-04-18","ARRUFO","0","2","0","2"
"2020-04-18","ARTEAGA","0","1","0","1"
"2020-04-18","AVELLANEDA","0","8","0","8"
"2020-04-18","BARRANCAS","0","2","1","3"
"2020-04-18","BERNARDO DE IRIGOYEN","0","1","0","1"
"2020-04-18","BIGAND","0","4","1","5"
"2020-04-18","BOMBAL","0","3","0","3"
"2020-04-18","BOUQUET","0","1","0","1"
"2020-04-18","CAFFERATA","0","1","0","1"
"2020-04-18","CALCHAQUI","0","3","0","3"
"2020-04-18","CAÑADA DE GOMEZ","1","19","0","20"
"2020-04-18","CAÑADA DEL UCLE","0","1","0","1"
"2020-04-18","CAPITAN BERMUDEZ","0","17","0","17"
"2020-04-18","CARCARAÑA","0","8","0","8"
"2020-04-18","CARLOS PELLEGRINI","0","1","0","1"
"2020-04-18","CARMEN","0","1","0","1"
"2020-04-18","CARRERAS","0","3","0","3"
"2020-04-18","CARRIZALES","0","1","0","1"
"2020-04-18","CASILDA","2","26","3","31"
"2020-04-18","CAYASTA","1","4","0","5"
"2020-04-18","CERES","0","13","0","13"
"2020-04-18","CHABAS","1","2","0","3"
"2020-04-18","CHAÑAR LADEADO","0","1","0","1"
"2020-04-18","CLASON","0","1","0","1"
"2020-04-18","COLONIA ROSA","0","1","0","1"
"2020-04-18","CORONDA","0","10","0","10"
"2020-04-18","CORONEL RODOLFO S. DOMINGUEZ","0","2","0","2"
"2020-04-18","CORREA","0","3","0","3"
"2020-04-18","DESVIO ARIJON","0","1","0","1"
"2020-04-18","DIEGO DE ALVEAR","0","1","0","1"
"2020-04-18","ELORTONDO","4","4","0","8"
"2020-04-18","EL RABON","0","1","0","1"
"2020-04-18","EL TREBOL","0","1","1","2"
"2020-04-18","EMPALME VILLA CONSTITUCION","0","1","0","1"
"2020-04-18","ESPERANZA","1","17","4","22"
"2020-04-18","FIGHIERA","0","2","0","2"
"2020-04-18","FIRMAT","1","10","2","13"
"2020-04-18","FLORENCIA","0","2","0","2"
"2020-04-18","FRANCK","1","5","2","8"
"2020-04-18","FRAY LUIS BELTRAN","0","8","2","10"
"2020-04-18","FRONTERA","0","1","4","5"
"2020-04-18","FUENTES","0","2","0","2"
"2020-04-18","FUNES","4","23","3","30"
"2020-04-18","GABOTO","0","3","0","3"
"2020-04-18","GALVEZ","9","15","0","24"
"2020-04-18","GENERAL LAGOS","0","1","0","1"
"2020-04-18","GESSLER","0","0","1","1"
"2020-04-18","GOBERNADOR CRESPO","0","1","0","1"
"2020-04-18","GODOY","0","1","0","1"
"2020-04-18","GRANADERO BAIGORRIA","1","41","0","42"
"2020-04-18","HELVECIA","2","13","1","16"
"2020-04-18","HUMBERTO PRIMO","0","1","0","1"
"2020-04-18","HUMBOLDT","1","1","0","2"
"2020-04-18","IBARLUCEA","0","3","1","4"
"2020-04-18","JOSEFINA","0","2","0","2"
"2020-04-18","JUNCAL","0","0","1","1"
"2020-04-18","LA BRAVA","0","1","0","1"
"2020-04-18","LA CRIOLLA","0","1","0","1"
"2020-04-18","LAGUNA PAIVA","0","3","0","3"
"2020-04-18","LANTERI","0","1","0","1"
"2020-04-18","LAS PAREJAS","1","4","1","6"
"2020-04-18","LAS ROSAS","1","3","0","4"
"2020-04-18","LAS TOSCAS","0","3","0","3"
"2020-04-18","LEHMANN","0","1","0","1"
"2020-04-18","LLAMBI CAMPBELL","3","1","0","4"
"2020-04-18","LOPEZ","0","2","0","2"
"2020-04-18","LOS QUIRQUINCHOS","0","1","0","1"
"2020-04-18","LUIS PALACIOS","0","1","0","1"
"2020-04-18","MACIEL","0","2","0","2"
"2020-04-18","MALABRIGO","0","1","0","1"
"2020-04-18","MARGARITA","0","2","1","3"
"2020-04-18","MARIA JUANA","0","1","0","1"
"2020-04-18","MARIA SUSANA","0","1","0","1"
"2020-04-18","MARIA TERESA","0","1","0","1"
"2020-04-18","MAXIMO PAZ","0","1","0","1"
"2020-04-18","MONJE","0","1","0","1"
"2020-04-18","MONTE VERA","0","7","0","7"
"2020-04-18","MURPHY","0","1","0","1"
"2020-04-18","NELSON","0","1","1","2"
"2020-04-18","OLIVEROS","3","4","1","8"
"2020-04-18","PAVON ARRIBA","0","1","0","1"
"2020-04-18","PEREZ","0","25","3","28"
"2020-04-18","PILAR","0","1","0","1"
"2020-04-18","PRESIDENTE ROCA","0","1","0","1"
"2020-04-18","PUEBLO ANDINO","2","1","0","3"
"2020-04-18","PUEBLO ESTHER","0","6","1","7"
"2020-04-18","PUEBLO IRIGOYEN","0","1","0","1"
"2020-04-18","PUERTO GENERAL SAN MARTIN","0","10","0","10"
"2020-04-18","PUERTO RECONQUISTA","0","1","0","1"
"2020-04-18","PUJATO","2","4","0","6"
"2020-04-18","RAFAELA","20","66","5","91"
"2020-04-18","RAMONA","0","2","0","2"
"2020-04-18","RECONQUISTA","0","26","1","27"
"2020-04-18","RECREO","0","11","1","12"
"2020-04-18","RICARDONE","0","3","0","3"
"2020-04-18","RINCON POTRERO","0","1","0","1"
"2020-04-18","ROLDAN","6","16","1","23"
"2020-04-18","ROMANG","0","1","0","1"
"2020-04-18","ROSARIO","95","1236","64","1395"
"2020-04-18","RUFINO","0","2","0","2"
"2020-04-18","SALTO GRANDE","0","2","0","2"
"2020-04-18","SAN ANTONIO DE OBLIGADO","0","1","0","1"
"2020-04-18","SAN CARLOS CENTRO","0","7","0","7"
"2020-04-18","SAN CARLOS SUD","1","0","0","1"
"2020-04-18","SAN CRISTOBAL","0","1","0","1"
"2020-04-18","SANFORD","0","1","0","1"
"2020-04-18","SAN GENARO","1","1","0","2"
"2020-04-18","SAN GUILLERMO","0","1","0","1"
"2020-04-18","SAN JAVIER","1","4","0","5"
"2020-04-18","SAN JERONIMO DEL SAUCE","0","0","1","1"
"2020-04-18","SAN JERONIMO NORTE","0","2","0","2"
"2020-04-18","SAN JERONIMO SUD","0","3","0","3"
"2020-04-18","SAN JORGE","0","6","1","7"
"2020-04-18","SAN JOSE DE LA ESQUINA","0","5","0","5"
"2020-04-18","SAN JOSE DEL RINCON","1","9","1","11"
"2020-04-18","SAN JUSTO","0","5","0","5"
"2020-04-18","SAN LORENZO","1","31","8","40"
"2020-04-18","SANTA CLARA DE BUENA VISTA","0","1","1","2"
"2020-04-18","SANTA FE","27","385","36","448"
"2020-04-18","SANTA ISABEL","0","1","1","2"
"2020-04-18","SANTA ROSA DE CALCHINES","0","1","0","1"
"2020-04-18","SANTO DOMINGO","0","1","0","1"
"2020-04-18","SANTO TOME","5","55","3","63"
"2020-04-18","SAN VICENTE","0","0","2","2"
"2020-04-18","SARGENTO CABRAL","0","0","1","1"
"2020-04-18","SARMIENTO","0","2","0","2"
"2020-04-18","SASTRE","0","2","0","2"
"2020-04-18","SAUCE VIEJO","1","13","1","15"
"2020-04-18","SERODINO","0","1","0","1"
"2020-04-18","SOLDINI","0","1","0","1"
"2020-04-18","SUARDI","0","2","0","2"
"2020-04-18","SUNCHALES","0","3","0","3"
"2020-04-18","SUSANA","0","1","0","1"
"2020-04-18","TACURAL","0","2","0","2"
"2020-04-18","TEODELINA","0","1","0","1"
"2020-04-18","TIMBUES","0","3","1","4"
"2020-04-18","TOSTADO","0","4","0","4"
"2020-04-18","TOTORAS","0","2","0","2"
"2020-04-18","VENADO TUERTO","5","28","4","37"
"2020-04-18","VERA","1","15","1","17"
"2020-04-18","VIDELA","0","1","0","1"
"2020-04-18","VILLA CAÑAS","0","1","0","1"
"2020-04-18","VILLA CONSTITUCION","9","17","0","26"
"2020-04-18","VILLA GOBERNADOR GALVEZ","2","60","9","71"
"2020-04-18","VILLA MINETTI","0","1","0","1"
"2020-04-18","VILLA MUGUETA","0","3","0","3"
"2020-04-18","VILLA OCAMPO","0","1","0","1"
"2020-04-18","WHEELWRIGHT","0","1","0","1"
"2020-04-18","ZAVALLA","0","1","0","1"
"2020-04-19","ACEBAL","0","1","0","1"
"2020-04-19","ALCORTA","0","2","0","2"
"2020-04-19","ALVAREZ","0","1","0","1"
"2020-04-19","ALVEAR","0","3","0","3"
"2020-04-19","ANGEL GALLARDO","0","4","0","4"
"2020-04-19","ARMSTRONG","2","6","1","9"
"2020-04-19","AROCENA","0","4","0","4"
"2020-04-19","ARROYO AGUIAR","0","1","0","1"
"2020-04-19","ARROYO LEYES","0","6","0","6"
"2020-04-19","ARROYO SECO","2","18","1","21"
"2020-04-19","ARRUFO","0","2","0","2"
"2020-04-19","ARTEAGA","0","1","0","1"
"2020-04-19","AVELLANEDA","0","8","0","8"
"2020-04-19","BARRANCAS","0","3","0","3"
"2020-04-19","BERNARDO DE IRIGOYEN","0","1","0","1"
"2020-04-19","BIGAND","0","7","0","7"
"2020-04-19","BOMBAL","0","3","0","3"
"2020-04-19","BOUQUET","0","1","0","1"
"2020-04-19","CAFFERATA","0","1","0","1"
"2020-04-19","CALCHAQUI","0","3","0","3"
"2020-04-19","CAÑADA DE GOMEZ","1","19","0","20"
"2020-04-19","CAÑADA DEL UCLE","0","1","0","1"
"2020-04-19","CAPITAN BERMUDEZ","0","17","0","17"
"2020-04-19","CARCARAÑA","0","9","0","9"
"2020-04-19","CARLOS PELLEGRINI","0","1","1","2"
"2020-04-19","CARMEN","0","1","0","1"
"2020-04-19","CARRERAS","0","3","0","3"
"2020-04-19","CARRIZALES","0","1","0","1"
"2020-04-19","CASILDA","2","28","1","31"
"2020-04-19","CAYASTA","1","4","0","5"
"2020-04-19","CERES","0","13","0","13"
"2020-04-19","CHABAS","1","2","0","3"
"2020-04-19","CHAÑAR LADEADO","0","1","0","1"
"2020-04-19","CLASON","0","1","0","1"
"2020-04-19","COLONIA ROSA","0","1","0","1"
"2020-04-19","CORONDA","0","10","0","10"
"2020-04-19","CORONEL RODOLFO S. DOMINGUEZ","0","2","0","2"
"2020-04-19","CORREA","0","3","0","3"
"2020-04-19","DESVIO ARIJON","0","1","0","1"
"2020-04-19","DIEGO DE ALVEAR","0","1","0","1"
"2020-04-19","ELORTONDO","4","4","0","8"
"2020-04-19","EL RABON","0","1","0","1"
"2020-04-19","EL TREBOL","0","2","0","2"
"2020-04-19","EMPALME VILLA CONSTITUCION","0","1","0","1"
"2020-04-19","ESPERANZA","1","21","0","22"
"2020-04-19","FIGHIERA","0","2","0","2"
"2020-04-19","FIRMAT","1","11","1","13"
"2020-04-19","FLORENCIA","0","2","0","2"
"2020-04-19","FRANCK","1","7","0","8"
"2020-04-19","FRAY LUIS BELTRAN","0","9","1","10"
"2020-04-19","FRONTERA","0","1","4","5"
"2020-04-19","FUENTES","0","2","0","2"
"2020-04-19","FUNES","4","27","1","32"
"2020-04-19","GABOTO","0","3","0","3"
"2020-04-19","GALVEZ","9","15","0","24"
"2020-04-19","GENERAL LAGOS","0","1","0","1"
"2020-04-19","GESSLER","0","0","1","1"
"2020-04-19","GOBERNADOR CRESPO","0","1","0","1"
"2020-04-19","GODOY","0","1","0","1"
"2020-04-19","GRANADERO BAIGORRIA","1","40","3","44"
"2020-04-19","HELVECIA","2","13","1","16"
"2020-04-19","HUMBERTO PRIMO","0","1","0","1"
"2020-04-19","HUMBOLDT","1","1","0","2"
"2020-04-19","IBARLUCEA","0","3","1","4"
"2020-04-19","JOSEFINA","0","2","0","2"
"2020-04-19","JUNCAL","0","1","0","1"
"2020-04-19","LA BRAVA","0","1","0","1"
"2020-04-19","LA CRIOLLA","0","1","0","1"
"2020-04-19","LAGUNA PAIVA","0","3","0","3"
"2020-04-19","LANTERI","0","1","0","1"
"2020-04-19","LAS PAREJAS","1","5","0","6"
"2020-04-19","LAS ROSAS","1","3","0","4"
"2020-04-19","LAS TOSCAS","0","3","0","3"
"2020-04-19","LA VANGUARDIA","0","1","0","1"
"2020-04-19","LEHMANN","0","1","0","1"
"2020-04-19","LLAMBI CAMPBELL","3","1","0","4"
"2020-04-19","LOPEZ","0","2","0","2"
"2020-04-19","LOS QUIRQUINCHOS","0","1","0","1"
"2020-04-19","LUIS PALACIOS","0","1","0","1"
"2020-04-19","MACIEL","0","2","0","2"
"2020-04-19","MALABRIGO","0","1","0","1"
"2020-04-19","MARGARITA","0","3","0","3"
"2020-04-19","MARIA JUANA","0","1","0","1"
"2020-04-19","MARIA SUSANA","0","1","0","1"
"2020-04-19","MARIA TERESA","0","1","0","1"
"2020-04-19","MAXIMO PAZ","0","1","0","1"
"2020-04-19","MONJE","0","1","0","1"
"2020-04-19","MONTES DE OCA","0","0","2","2"
"2020-04-19","MONTE VERA","0","7","0","7"
"2020-04-19","MURPHY","0","1","0","1"
"2020-04-19","NELSON","0","2","0","2"
"2020-04-19","OLIVEROS","3","4","1","8"
"2020-04-19","PAVON ARRIBA","0","1","0","1"
"2020-04-19","PEREZ","0","29","2","31"
"2020-04-19","PILAR","0","1","0","1"
"2020-04-19","PRESIDENTE ROCA","0","1","0","1"
"2020-04-19","PUEBLO ANDINO","2","1","0","3"
"2020-04-19","PUEBLO ESTHER","0","8","0","8"
"2020-04-19","PUEBLO IRIGOYEN","0","1","0","1"
"2020-04-19","PUERTO GENERAL SAN MARTIN","0","10","1","11"
"2020-04-19","PUERTO RECONQUISTA","0","1","0","1"
"2020-04-19","PUJATO","2","4","0","6"
"2020-04-19","RAFAELA","20","66","8","94"
"2020-04-19","RAMONA","0","2","0","2"
"2020-04-19","RECONQUISTA","0","26","2","28"
"2020-04-19","RECREO","0","12","0","12"
"2020-04-19","RICARDONE","0","3","0","3"
"2020-04-19","RINCON POTRERO","0","1","0","1"
"2020-04-19","ROLDAN","6","17","0","23"
"2020-04-19","ROMANG","0","1","0","1"
"2020-04-19","ROSARIO","96","1295","78","1469"
"2020-04-19","RUFINO","0","2","2","4"
"2020-04-19","SALTO GRANDE","0","2","0","2"
"2020-04-19","SAN ANTONIO DE OBLIGADO","0","1","0","1"
"2020-04-19","SAN CARLOS CENTRO","0","7","0","7"
"2020-04-19","SAN CARLOS SUD","1","0","0","1"
"2020-04-19","SAN CRISTOBAL","0","1","0","1"
"2020-04-19","SANFORD","0","1","0","1"
"2020-04-19","SAN FRANCISCO DE SANTA FE","0","1","0","1"
"2020-04-19","SAN GENARO","1","1","0","2"
"2020-04-19","SAN GUILLERMO","0","1","0","1"
"2020-04-19","SAN JAVIER","1","4","0","5"
"2020-04-19","SAN JERONIMO DEL SAUCE","0","1","0","1"
"2020-04-19","SAN JERONIMO NORTE","0","2","0","2"
"2020-04-19","SAN JERONIMO SUD","0","3","0","3"
"2020-04-19","SAN JORGE","0","6","1","7"
"2020-04-19","SAN JOSE DE LA ESQUINA","0","5","0","5"
"2020-04-19","SAN JOSE DEL RINCON","1","9","1","11"
"2020-04-19","SAN JUSTO","0","5","0","5"
"2020-04-19","SAN LORENZO","1","33","7","41"
"2020-04-19","SANTA CLARA DE BUENA VISTA","0","2","0","2"
"2020-04-19","SANTA FE","27","401","20","448"
"2020-04-19","SANTA ISABEL","0","1","1","2"
"2020-04-19","SANTA ROSA DE CALCHINES","0","1","0","1"
"2020-04-19","SANTO DOMINGO","0","1","0","1"
"2020-04-19","SANTO TOME","5","58","1","64"
"2020-04-19","SAN VICENTE","0","2","0","2"
"2020-04-19","SARGENTO CABRAL","0","1","0","1"
"2020-04-19","SARMIENTO","0","2","0","2"
"2020-04-19","SASTRE","0","2","0","2"
"2020-04-19","SAUCE VIEJO","1","14","0","15"
"2020-04-19","SERODINO","0","1","0","1"
"2020-04-19","SOLDINI","0","1","0","1"
"2020-04-19","SUARDI","0","2","0","2"
"2020-04-19","SUNCHALES","0","3","0","3"
"2020-04-19","SUSANA","0","1","0","1"
"2020-04-19","TACURAL","0","2","0","2"
"2020-04-19","TEODELINA","0","1","0","1"
"2020-04-19","TIMBUES","0","3","1","4"
"2020-04-19","TOSTADO","0","4","0","4"
"2020-04-19","TOTORAS","0","2","0","2"
"2020-04-19","VENADO TUERTO","5","30","6","41"
"2020-04-19","VERA","1","16","0","17"
"2020-04-19","VIDELA","0","1","0","1"
"2020-04-19","VILLA CAÑAS","0","1","0","1"
"2020-04-19","VILLA CONSTITUCION","9","18","2","29"
"2020-04-19","VILLA GOBERNADOR GALVEZ","2","68","4","74"
"2020-04-19","VILLA MINETTI","0","1","0","1"
"2020-04-19","VILLA MUGUETA","0","3","0","3"
"2020-04-19","VILLA OCAMPO","0","1","0","1"
"2020-04-19","WHEELWRIGHT","0","2","0","2"
"2020-04-19","ZAVALLA","0","1","0","1"
"2020-04-20","ACEBAL","0","1","0","1"
"2020-04-20","ALCORTA","0","2","0","2"
"2020-04-20","ALVAREZ","0","1","0","1"
"2020-04-20","ALVEAR","0","3","0","3"
"2020-04-20","ANGEL GALLARDO","0","4","0","4"
"2020-04-20","ARMSTRONG","2","7","0","9"
"2020-04-20","AROCENA","0","4","0","4"
"2020-04-20","ARROYO AGUIAR","0","1","0","1"
"2020-04-20","ARROYO LEYES","0","6","0","6"
"2020-04-20","ARROYO SECO","2","19","0","21"
"2020-04-20","ARRUFO","0","2","0","2"
"2020-04-20","ARTEAGA","0","1","0","1"
"2020-04-20","AVELLANEDA","0","8","1","9"
"2020-04-20","BARRANCAS","0","3","0","3"
"2020-04-20","BERNARDO DE IRIGOYEN","0","1","0","1"
"2020-04-20","BIGAND","0","7","0","7"
"2020-04-20","BOMBAL","0","3","0","3"
"2020-04-20","BOUQUET","0","1","0","1"
"2020-04-20","CAFFERATA","0","1","0","1"
"2020-04-20","CALCHAQUI","0","3","0","3"
"2020-04-20","CAÑADA DE GOMEZ","1","19","0","20"
"2020-04-20","CAÑADA DEL UCLE","0","1","0","1"
"2020-04-20","CAPITAN BERMUDEZ","0","18","2","20"
"2020-04-20","CARCARAÑA","0","9","0","9"
"2020-04-20","CARLOS PELLEGRINI","0","2","0","2"
"2020-04-20","CARMEN","0","1","0","1"
"2020-04-20","CARRERAS","0","3","0","3"
"2020-04-20","CARRIZALES","0","1","0","1"
"2020-04-20","CASILDA","2","29","1","32"
"2020-04-20","CAYASTA","1","4","0","5"
"2020-04-20","CERES","0","13","0","13"
"2020-04-20","CHABAS","1","2","0","3"
"2020-04-20","CHAÑAR LADEADO","0","1","0","1"
"2020-04-20","CLASON","0","1","0","1"
"2020-04-20","COLONIA ROSA","0","1","0","1"
"2020-04-20","CORONDA","0","10","0","10"
"2020-04-20","CORONEL RODOLFO S. DOMINGUEZ","0","2","0","2"
"2020-04-20","CORREA","0","3","0","3"
"2020-04-20","DESVIO ARIJON","0","1","0","1"
"2020-04-20","DIEGO DE ALVEAR","0","1","0","1"
"2020-04-20","ELORTONDO","4","4","0","8"
"2020-04-20","EL RABON","0","1","0","1"
"2020-04-20","EL TREBOL","0","2","0","2"
"2020-04-20","EMPALME VILLA CONSTITUCION","0","1","0","1"
"2020-04-20","ESPERANZA","1","21","0","22"
"2020-04-20","FIGHIERA","0","3","0","3"
"2020-04-20","FIRMAT","1","11","0","12"
"2020-04-20","FLORENCIA","0","2","0","2"
"2020-04-20","FRANCK","1","7","0","8"
"2020-04-20","FRAY LUIS BELTRAN","0","13","0","13"
"2020-04-20","FRONTERA","0","5","0","5"
"2020-04-20","FUENTES","0","2","0","2"
"2020-04-20","FUNES","4","28","1","33"
"2020-04-20","GABOTO","0","3","0","3"
"2020-04-20","GALVEZ","9","15","1","25"
"2020-04-20","GENERAL LAGOS","0","1","0","1"
"2020-04-20","GESSLER","0","0","1","1"
"2020-04-20","GOBERNADOR CRESPO","0","1","0","1"
"2020-04-20","GODOY","0","1","0","1"
"2020-04-20","GRANADERO BAIGORRIA","1","45","1","47"
"2020-04-20","HELVECIA","2","13","1","16"
"2020-04-20","HUMBERTO PRIMO","0","1","0","1"
"2020-04-20","HUMBOLDT","1","1","0","2"
"2020-04-20","IBARLUCEA","0","4","0","4"
"2020-04-20","JOSEFINA","0","2","0","2"
"2020-04-20","JUNCAL","0","1","0","1"
"2020-04-20","LA BRAVA","0","1","0","1"
"2020-04-20","LA CRIOLLA","0","1","0","1"
"2020-04-20","LAGUNA PAIVA","0","3","0","3"
"2020-04-20","LANTERI","0","1","0","1"
"2020-04-20","LAS PAREJAS","1","5","0","6"
"2020-04-20","LAS ROSAS","1","3","2","6"
"2020-04-20","LAS TOSCAS","0","3","0","3"
"2020-04-20","LA VANGUARDIA","0","1","0","1"
"2020-04-20","LEHMANN","0","1","0","1"
"2020-04-20","LLAMBI CAMPBELL","3","1","0","4"
"2020-04-20","LOPEZ","0","2","0","2"
"2020-04-20","LOS QUIRQUINCHOS","0","1","0","1"
"2020-04-20","LUIS PALACIOS","0","1","0","1"
"2020-04-20","MACIEL","0","2","0","2"
"2020-04-20","MALABRIGO","0","1","0","1"
"2020-04-20","MARGARITA","0","3","0","3"
"2020-04-20","MARIA JUANA","0","1","0","1"
"2020-04-20","MARIA SUSANA","0","1","0","1"
"2020-04-20","MARIA TERESA","0","1","0","1"
"2020-04-20","MAXIMO PAZ","0","1","0","1"
"2020-04-20","MONJE","0","1","1","2"
"2020-04-20","MONTES DE OCA","0","2","0","2"
"2020-04-20","MONTE VERA","0","7","0","7"
"2020-04-20","MURPHY","0","1","0","1"
"2020-04-20","NELSON","0","2","0","2"
"2020-04-20","OLIVEROS","3","5","0","8"
"2020-04-20","PAVON ARRIBA","0","1","0","1"
"2020-04-20","PEREZ","0","34","1","35"
"2020-04-20","PILAR","0","1","0","1"
"2020-04-20","PRESIDENTE ROCA","0","1","0","1"
"2020-04-20","PUEBLO ANDINO","2","2","0","4"
"2020-04-20","PUEBLO ESTHER","0","9","0","9"
"2020-04-20","PUEBLO IRIGOYEN","0","1","0","1"
"2020-04-20","PUERTO GENERAL SAN MARTIN","0","12","0","12"
"2020-04-20","PUERTO RECONQUISTA","0","1","0","1"
"2020-04-20","PUJATO","2","4","0","6"
"2020-04-20","RAFAELA","20","67","13","100"
"2020-04-20","RAMONA","0","2","0","2"
"2020-04-20","RECONQUISTA","0","26","2","28"
"2020-04-20","RECREO","0","12","0","12"
"2020-04-20","RICARDONE","0","3","0","3"
"2020-04-20","RINCON POTRERO","0","1","0","1"
"2020-04-20","ROLDAN","6","17","0","23"
"2020-04-20","ROMANG","0","1","0","1"
"2020-04-20","ROSARIO","96","1396","60","1552"
"2020-04-20","RUFINO","0","4","2","6"
"2020-04-20","SALTO GRANDE","0","2","0","2"
"2020-04-20","SAN ANTONIO DE OBLIGADO","0","1","0","1"
"2020-04-20","SAN CARLOS CENTRO","0","7","1","8"
"2020-04-20","SAN CARLOS SUD","1","0","0","1"
"2020-04-20","SAN CRISTOBAL","0","1","0","1"
"2020-04-20","SANFORD","0","1","0","1"
"2020-04-20","SAN FRANCISCO DE SANTA FE","0","1","0","1"
"2020-04-20","SAN GENARO","1","1","1","3"
"2020-04-20","SAN GUILLERMO","0","1","0","1"
"2020-04-20","SAN JAVIER","1","4","1","6"
"2020-04-20","SAN JERONIMO DEL SAUCE","0","1","0","1"
"2020-04-20","SAN JERONIMO NORTE","0","2","0","2"
"2020-04-20","SAN JERONIMO SUD","0","3","0","3"
"2020-04-20","SAN JORGE","0","6","1","7"
"2020-04-20","SAN JOSE DE LA ESQUINA","0","5","0","5"
"2020-04-20","SAN JOSE DEL RINCON","1","9","1","11"
"2020-04-20","SAN JUSTO","0","5","0","5"
"2020-04-20","SAN LORENZO","1","38","5","44"
"2020-04-20","SANTA CLARA DE BUENA VISTA","0","2","0","2"
"2020-04-20","SANTA FE","27","412","45","484"
"2020-04-20","SANTA ISABEL","0","1","1","2"
"2020-04-20","SANTA ROSA DE CALCHINES","0","1","1","2"
"2020-04-20","SANTO DOMINGO","0","1","0","1"
"2020-04-20","SANTO TOME","5","58","2","65"
"2020-04-20","SAN VICENTE","0","2","0","2"
"2020-04-20","SARGENTO CABRAL","0","1","0","1"
"2020-04-20","SARMIENTO","0","2","0","2"
"2020-04-20","SASTRE","0","2","0","2"
"2020-04-20","SAUCE VIEJO","1","14","1","16"
"2020-04-20","SERODINO","0","1","1","2"
"2020-04-20","SOLDINI","0","1","0","1"
"2020-04-20","SUARDI","0","2","0","2"
"2020-04-20","SUNCHALES","0","3","0","3"
"2020-04-20","SUSANA","0","1","0","1"
"2020-04-20","TACURAL","0","2","0","2"
"2020-04-20","TEODELINA","0","4","0","4"
"2020-04-20","TIMBUES","0","3","1","4"
"2020-04-20","TOSTADO","0","4","0","4"
"2020-04-20","TOTORAS","0","2","0","2"
"2020-04-20","VENADO TUERTO","7","34","3","44"
"2020-04-20","VERA","1","16","0","17"
"2020-04-20","VIDELA","0","1","0","1"
"2020-04-20","VILLA CAÑAS","0","1","0","1"
"2020-04-20","VILLA CONSTITUCION","9","20","1","30"
"2020-04-20","VILLA GOBERNADOR GALVEZ","2","71","6","79"
"2020-04-20","VILLA MINETTI","0","1","0","1"
"2020-04-20","VILLA MUGUETA","0","3","0","3"
"2020-04-20","VILLA OCAMPO","0","1","0","1"
"2020-04-20","WHEELWRIGHT","0","2","0","2"
"2020-04-20","ZAVALLA","0","1","0","1"
"2020-04-21","ACEBAL","0","2","0","2"
"2020-04-21","ALBARELLOS","0","1","0","1"
"2020-04-21","ALCORTA","0","2","0","2"
"2020-04-21","ALVAREZ","0","1","2","3"
"2020-04-21","ALVEAR","0","3","1","4"
"2020-04-21","ANGEL GALLARDO","0","4","0","4"
"2020-04-21","ARMSTRONG","2","7","0","9"
"2020-04-21","AROCENA","0","4","0","4"
"2020-04-21","ARROYO AGUIAR","0","1","0","1"
"2020-04-21","ARROYO LEYES","0","6","0","6"
"2020-04-21","ARROYO SECO","2","19","0","21"
"2020-04-21","ARRUFO","0","2","0","2"
"2020-04-21","ARTEAGA","0","1","0","1"
"2020-04-21","AVELLANEDA","0","8","1","9"
"2020-04-21","BARRANCAS","0","3","0","3"
"2020-04-21","BERNARDO DE IRIGOYEN","0","1","0","1"
"2020-04-21","BIGAND","0","7","2","9"
"2020-04-21","BOMBAL","0","3","0","3"
"2020-04-21","BOUQUET","0","1","0","1"
"2020-04-21","CAFFERATA","0","1","0","1"
"2020-04-21","CALCHAQUI","0","3","0","3"
"2020-04-21","CAÑADA DE GOMEZ","1","19","0","20"
"2020-04-21","CAÑADA DEL UCLE","0","1","0","1"
"2020-04-21","CAPITAN BERMUDEZ","0","20","1","21"
"2020-04-21","CARCARAÑA","0","9","1","10"
"2020-04-21","CARLOS PELLEGRINI","0","2","0","2"
"2020-04-21","CARMEN","0","1","0","1"
"2020-04-21","CARRERAS","0","3","0","3"
"2020-04-21","CARRIZALES","0","1","0","1"
"2020-04-21","CASILDA","2","29","1","32"
"2020-04-21","CAYASTA","1","4","0","5"
"2020-04-21","CERES","0","13","0","13"
"2020-04-21","CHABAS","1","2","0","3"
"2020-04-21","CHAÑAR LADEADO","0","1","0","1"
"2020-04-21","CLASON","0","1","0","1"
"2020-04-21","COLONIA ROSA","0","1","0","1"
"2020-04-21","CORONDA","0","10","0","10"
"2020-04-21","CORONEL RODOLFO S. DOMINGUEZ","0","2","0","2"
"2020-04-21","CORREA","0","4","0","4"
"2020-04-21","DESVIO ARIJON","0","1","0","1"
"2020-04-21","DIEGO DE ALVEAR","0","1","0","1"
"2020-04-21","ELORTONDO","4","4","0","8"
"2020-04-21","EL RABON","0","1","0","1"
"2020-04-21","EL TREBOL","0","2","0","2"
"2020-04-21","EMPALME VILLA CONSTITUCION","0","1","0","1"
"2020-04-21","ESPERANZA","1","21","0","22"
"2020-04-21","FIGHIERA","0","3","0","3"
"2020-04-21","FIRMAT","1","11","0","12"
"2020-04-21","FLORENCIA","0","2","0","2"
"2020-04-21","FRANCK","1","7","0","8"
"2020-04-21","FRAY LUIS BELTRAN","0","13","0","13"
"2020-04-21","FRONTERA","0","5","0","5"
"2020-04-21","FUENTES","0","2","0","2"
"2020-04-21","FUNES","4","29","2","35"
"2020-04-21","GABOTO","0","3","0","3"
"2020-04-21","GALVEZ","9","16","0","25"
"2020-04-21","GENERAL LAGOS","0","1","0","1"
"2020-04-21","GESSLER","0","0","1","1"
"2020-04-21","GOBERNADOR CRESPO","0","1","0","1"
"2020-04-21","GODOY","0","1","0","1"
"2020-04-21","GRANADERO BAIGORRIA","1","46","2","49"
"2020-04-21","HELVECIA","2","13","1","16"
"2020-04-21","HUMBERTO PRIMO","0","1","0","1"
"2020-04-21","HUMBOLDT","1","1","0","2"
"2020-04-21","IBARLUCEA","0","4","0","4"
"2020-04-21","JOSEFINA","0","2","0","2"
"2020-04-21","JUNCAL","0","1","0","1"
"2020-04-21","LA BRAVA","0","1","0","1"
"2020-04-21","LA CRIOLLA","0","1","0","1"
"2020-04-21","LAGUNA PAIVA","0","3","0","3"
"2020-04-21","LANTERI","0","1","0","1"
"2020-04-21","LAS PAREJAS","1","5","0","6"
"2020-04-21","LAS ROSAS","1","4","1","6"
"2020-04-21","LAS TOSCAS","0","3","0","3"
"2020-04-21","LA VANGUARDIA","0","1","0","1"
"2020-04-21","LEHMANN","0","1","0","1"
"2020-04-21","LLAMBI CAMPBELL","3","1","0","4"
"2020-04-21","LOPEZ","0","2","0","2"
"2020-04-21","LOS MOLINOS","0","0","1","1"
"2020-04-21","LOS QUIRQUINCHOS","0","1","0","1"
"2020-04-21","LUIS PALACIOS","0","1","0","1"
"2020-04-21","MACIEL","0","2","0","2"
"2020-04-21","MALABRIGO","0","1","0","1"
"2020-04-21","MARGARITA","0","3","0","3"
"2020-04-21","MARIA JUANA","0","1","0","1"
"2020-04-21","MARIA SUSANA","0","1","0","1"
"2020-04-21","MARIA TERESA","0","1","0","1"
"2020-04-21","MAXIMO PAZ","0","1","0","1"
"2020-04-21","MONJE","0","1","1","2"
"2020-04-21","MONTES DE OCA","0","2","0","2"
"2020-04-21","MONTE VERA","0","7","0","7"
"2020-04-21","MURPHY","0","1","0","1"
"2020-04-21","NELSON","0","2","0","2"
"2020-04-21","OLIVEROS","3","5","1","9"
"2020-04-21","PAVON ARRIBA","0","1","0","1"
"2020-04-21","PEREZ","0","35","1","36"
"2020-04-21","PILAR","0","1","0","1"
"2020-04-21","PIÑERO","0","1","0","1"
"2020-04-21","PRESIDENTE ROCA","0","1","0","1"
"2020-04-21","PUEBLO ANDINO","2","2","0","4"
"2020-04-21","PUEBLO ESTHER","0","10","0","10"
"2020-04-21","PUEBLO IRIGOYEN","0","1","0","1"
"2020-04-21","PUERTO GENERAL SAN MARTIN","0","12","0","12"
"2020-04-21","PUERTO RECONQUISTA","0","1","0","1"
"2020-04-21","PUJATO","2","4","0","6"
"2020-04-21","RAFAELA","21","75","7","103"
"2020-04-21","RAMONA","0","2","0","2"
"2020-04-21","RECONQUISTA","0","26","3","29"
"2020-04-21","RECREO","0","12","0","12"
"2020-04-21","RICARDONE","0","3","0","3"
"2020-04-21","RINCON POTRERO","0","1","0","1"
"2020-04-21","ROLDAN","6","17","0","23"
"2020-04-21","ROMANG","0","1","0","1"
"2020-04-21","ROSARIO","96","1486","48","1630"
"2020-04-21","RUFINO","0","6","0","6"
"2020-04-21","SALTO GRANDE","0","2","0","2"
"2020-04-21","SAN ANTONIO DE OBLIGADO","0","1","0","1"
"2020-04-21","SAN CARLOS CENTRO","0","8","0","8"
"2020-04-21","SAN CARLOS SUD","1","0","0","1"
"2020-04-21","SAN CRISTOBAL","0","1","0","1"
"2020-04-21","SANFORD","0","1","0","1"
"2020-04-21","SAN FRANCISCO DE SANTA FE","0","1","0","1"
"2020-04-21","SAN GENARO","1","1","2","4"
"2020-04-21","SAN GUILLERMO","0","1","0","1"
"2020-04-21","SAN JAVIER","1","5","0","6"
"2020-04-21","SAN JERONIMO DEL SAUCE","0","1","0","1"
"2020-04-21","SAN JERONIMO NORTE","0","2","0","2"
"2020-04-21","SAN JERONIMO SUD","0","3","0","3"
"2020-04-21","SAN JORGE","0","6","1","7"
"2020-04-21","SAN JOSE DE LA ESQUINA","0","5","0","5"
"2020-04-21","SAN JOSE DEL RINCON","1","9","1","11"
"2020-04-21","SAN JUSTO","0","5","0","5"
"2020-04-21","SAN LORENZO","1","39","4","44"
"2020-04-21","SANTA CLARA DE BUENA VISTA","0","2","0","2"
"2020-04-21","SANTA FE","27","426","44","497"
"2020-04-21","SANTA ISABEL","0","1","1","2"
"2020-04-21","SANTA ROSA DE CALCHINES","0","1","1","2"
"2020-04-21","SANTO DOMINGO","0","1","0","1"
"2020-04-21","SANTO TOME","5","59","2","66"
"2020-04-21","SAN VICENTE","0","2","0","2"
"2020-04-21","SARGENTO CABRAL","0","1","0","1"
"2020-04-21","SARMIENTO","0","2","0","2"
"2020-04-21","SASTRE","0","2","0","2"
"2020-04-21","SAUCE VIEJO","1","15","0","16"
"2020-04-21","SERODINO","0","2","0","2"
"2020-04-21","SOLDINI","0","1","0","1"
"2020-04-21","SUARDI","0","2","0","2"
"2020-04-21","SUNCHALES","0","3","0","3"
"2020-04-21","SUSANA","0","1","0","1"
"2020-04-21","TACURAL","0","2","0","2"
"2020-04-21","TEODELINA","0","4","0","4"
"2020-04-21","TIMBUES","0","3","1","4"
"2020-04-21","TOSTADO","0","4","0","4"
"2020-04-21","TOTORAS","0","2","0","2"
"2020-04-21","VENADO TUERTO","7","34","3","44"
"2020-04-21","VERA","1","16","0","17"
"2020-04-21","VIDELA","0","1","0","1"
"2020-04-21","VILLA CAÑAS","0","1","0","1"
"2020-04-21","VILLA CONSTITUCION","9","22","0","31"
"2020-04-21","VILLA GOBERNADOR GALVEZ","2","78","3","83"
"2020-04-21","VILLA MINETTI","0","1","0","1"
"2020-04-21","VILLA MUGUETA","0","3","0","3"
"2020-04-21","VILLA OCAMPO","0","1","0","1"
"2020-04-21","WHEELWRIGHT","0","2","0","2"
"2020-04-21","ZAVALLA","0","1","0","1"
"2020-04-22","ACEBAL","0","2","0","2"
"2020-04-22","ALBARELLOS","0","1","0","1"
"2020-04-22","ALCORTA","0","2","0","2"
"2020-04-22","ALVAREZ","0","3","0","3"
"2020-04-22","ALVEAR","0","4","0","4"
"2020-04-22","ANGEL GALLARDO","0","4","0","4"
"2020-04-22","ARMSTRONG","2","7","0","9"
"2020-04-22","AROCENA","0","4","0","4"
"2020-04-22","ARROYO AGUIAR","0","1","0","1"
"2020-04-22","ARROYO LEYES","0","6","1","7"
"2020-04-22","ARROYO SECO","2","19","0","21"
"2020-04-22","ARRUFO","0","2","0","2"
"2020-04-22","ARTEAGA","0","1","0","1"
"2020-04-22","AVELLANEDA","0","9","0","9"
"2020-04-22","BARRANCAS","0","3","0","3"
"2020-04-22","BERNARDO DE IRIGOYEN","0","1","0","1"
"2020-04-22","BIGAND","0","9","0","9"
"2020-04-22","BOMBAL","0","3","0","3"
"2020-04-22","BOUQUET","0","1","0","1"
"2020-04-22","CAFFERATA","0","1","0","1"
"2020-04-22","CALCHAQUI","0","3","0","3"
"2020-04-22","CAÑADA DE GOMEZ","1","19","0","20"
"2020-04-22","CAÑADA DEL UCLE","0","1","0","1"
"2020-04-22","CAPITAN BERMUDEZ","0","22","2","24"
"2020-04-22","CARCARAÑA","0","10","0","10"
"2020-04-22","CARLOS PELLEGRINI","0","2","0","2"
"2020-04-22","CARMEN","0","1","0","1"
"2020-04-22","CARRERAS","0","3","0","3"
"2020-04-22","CARRIZALES","0","1","0","1"
"2020-04-22","CASILDA","2","29","1","32"
"2020-04-22","CAYASTA","1","4","0","5"
"2020-04-22","CERES","0","13","1","14"
"2020-04-22","CHABAS","1","2","0","3"
"2020-04-22","CHAÑAR LADEADO","0","1","0","1"
"2020-04-22","CLASON","0","1","0","1"
"2020-04-22","COLONIA ROSA","0","1","0","1"
"2020-04-22","CORONDA","0","10","0","10"
"2020-04-22","CORONEL RODOLFO S. DOMINGUEZ","0","2","0","2"
"2020-04-22","CORREA","0","4","0","4"
"2020-04-22","DESVIO ARIJON","0","1","0","1"
"2020-04-22","DIEGO DE ALVEAR","0","1","0","1"
"2020-04-22","ELORTONDO","4","4","0","8"
"2020-04-22","EL RABON","0","1","0","1"
"2020-04-22","EL TREBOL","0","2","0","2"
"2020-04-22","EMPALME VILLA CONSTITUCION","0","1","0","1"
"2020-04-22","ESPERANZA","1","21","0","22"
"2020-04-22","FIGHIERA","0","3","0","3"
"2020-04-22","FIRMAT","1","11","0","12"
"2020-04-22","FLORENCIA","0","2","0","2"
"2020-04-22","FRANCK","1","7","0","8"
"2020-04-22","FRAY LUIS BELTRAN","0","14","2","16"
"2020-04-22","FRONTERA","0","5","0","5"
"2020-04-22","FUENTES","0","2","0","2"
"2020-04-22","FUNES","5","32","1","38"
"2020-04-22","GABOTO","0","3","0","3"
"2020-04-22","GALVEZ","9","16","0","25"
"2020-04-22","GENERAL LAGOS","0","1","0","1"
"2020-04-22","GESSLER","0","0","1","1"
"2020-04-22","GOBERNADOR CRESPO","0","1","0","1"
"2020-04-22","GODOY","0","1","0","1"
"2020-04-22","GRANADERO BAIGORRIA","1","49","2","52"
"2020-04-22","HELVECIA","2","13","2","17"
"2020-04-22","HUMBERTO PRIMO","0","1","0","1"
"2020-04-22","HUMBOLDT","1","1","0","2"
"2020-04-22","IBARLUCEA","0","5","0","5"
"2020-04-22","JOSEFINA","0","2","0","2"
"2020-04-22","JUNCAL","0","1","0","1"
"2020-04-22","LA BRAVA","0","1","0","1"
"2020-04-22","LA CRIOLLA","0","1","0","1"
"2020-04-22","LAGUNA PAIVA","0","3","1","4"
"2020-04-22","LANTERI","0","1","0","1"
"2020-04-22","LAS PAREJAS","1","5","0","6"
"2020-04-22","LAS ROSAS","1","5","0","6"
"2020-04-22","LAS TOSCAS","0","3","0","3"
"2020-04-22","LA VANGUARDIA","0","1","0","1"
"2020-04-22","LEHMANN","0","1","0","1"
"2020-04-22","LLAMBI CAMPBELL","3","1","0","4"
"2020-04-22","LOPEZ","0","2","0","2"
"2020-04-22","LOS MOLINOS","0","1","0","1"
"2020-04-22","LOS QUIRQUINCHOS","0","1","0","1"
"2020-04-22","LUIS PALACIOS","0","1","0","1"
"2020-04-22","MACIEL","0","2","0","2"
"2020-04-22","MALABRIGO","0","1","0","1"
"2020-04-22","MARGARITA","0","3","0","3"
"2020-04-22","MARIA JUANA","0","1","1","2"
"2020-04-22","MARIA SUSANA","0","1","0","1"
"2020-04-22","MARIA TERESA","0","1","0","1"
"2020-04-22","MAXIMO PAZ","0","1","0","1"
"2020-04-22","MONJE","0","1","1","2"
"2020-04-22","MONTEFIORE","0","0","1","1"
"2020-04-22","MONTES DE OCA","0","2","0","2"
"2020-04-22","MONTE VERA","0","7","0","7"
"2020-04-22","MURPHY","0","2","0","2"
"2020-04-22","NELSON","0","2","1","3"
"2020-04-22","OLIVEROS","3","6","0","9"
"2020-04-22","PAVON ARRIBA","0","1","0","1"
"2020-04-22","PEREZ","0","35","3","38"
"2020-04-22","PILAR","0","1","0","1"
"2020-04-22","PIÑERO","0","1","0","1"
"2020-04-22","PRESIDENTE ROCA","0","1","0","1"
"2020-04-22","PUEBLO ANDINO","2","2","0","4"
"2020-04-22","PUEBLO ESTHER","0","10","0","10"
"2020-04-22","PUEBLO IRIGOYEN","0","1","0","1"
"2020-04-22","PUERTO GENERAL SAN MARTIN","0","13","0","13"
"2020-04-22","PUERTO RECONQUISTA","0","1","0","1"
"2020-04-22","PUJATO","2","4","0","6"
"2020-04-22","RAFAELA","21","77","5","103"
"2020-04-22","RAMONA","0","2","0","2"
"2020-04-22","RECONQUISTA","0","27","2","29"
"2020-04-22","RECREO","0","12","0","12"
"2020-04-22","RICARDONE","0","3","0","3"
"2020-04-22","RINCON POTRERO","0","1","0","1"
"2020-04-22","ROLDAN","6","21","1","28"
"2020-04-22","ROMANG","0","1","0","1"
"2020-04-22","ROSARIO","97","1596","26","1719"
"2020-04-22","RUFINO","0","6","0","6"
"2020-04-22","SALTO GRANDE","0","2","0","2"
"2020-04-22","SAN ANTONIO DE OBLIGADO","0","1","0","1"
"2020-04-22","SAN CARLOS CENTRO","0","8","0","8"
"2020-04-22","SAN CARLOS SUD","1","0","0","1"
"2020-04-22","SAN CRISTOBAL","0","1","1","2"
"2020-04-22","SAN EDUARDO","0","1","0","1"
"2020-04-22","SANFORD","0","1","0","1"
"2020-04-22","SAN FRANCISCO DE SANTA FE","0","1","0","1"
"2020-04-22","SAN GENARO","1","3","0","4"
"2020-04-22","SAN GUILLERMO","0","1","1","2"
"2020-04-22","SAN JAVIER","1","5","0","6"
"2020-04-22","SAN JERONIMO DEL SAUCE","0","1","0","1"
"2020-04-22","SAN JERONIMO NORTE","0","2","0","2"
"2020-04-22","SAN JERONIMO SUD","0","3","0","3"
"2020-04-22","SAN JORGE","0","7","0","7"
"2020-04-22","SAN JOSE DE LA ESQUINA","0","5","0","5"
"2020-04-22","SAN JOSE DEL RINCON","1","9","1","11"
"2020-04-22","SAN JUSTO","0","5","0","5"
"2020-04-22","SAN LORENZO","1","41","7","49"
"2020-04-22","SANTA CLARA DE BUENA VISTA","0","2","0","2"
"2020-04-22","SANTA FE","27","449","48","524"
"2020-04-22","SANTA ISABEL","0","1","1","2"
"2020-04-22","SANTA ROSA DE CALCHINES","0","2","0","2"
"2020-04-22","SANTO DOMINGO","0","1","0","1"
"2020-04-22","SANTO TOME","5","61","3","69"
"2020-04-22","SAN VICENTE","0","2","0","2"
"2020-04-22","SARGENTO CABRAL","0","1","0","1"
"2020-04-22","SARMIENTO","0","2","0","2"
"2020-04-22","SASTRE","0","2","0","2"
"2020-04-22","SAUCE VIEJO","1","15","0","16"
"2020-04-22","SERODINO","0","2","0","2"
"2020-04-22","SOLDINI","0","1","0","1"
"2020-04-22","SUARDI","0","2","0","2"
"2020-04-22","SUNCHALES","0","3","0","3"
"2020-04-22","SUSANA","0","1","0","1"
"2020-04-22","TACURAL","0","2","0","2"
"2020-04-22","TEODELINA","0","4","0","4"
"2020-04-22","TIMBUES","0","3","1","4"
"2020-04-22","TOSTADO","0","4","0","4"
"2020-04-22","TOTORAS","0","2","0","2"
"2020-04-22","VENADO TUERTO","10","40","4","54"
"2020-04-22","VERA","1","16","0","17"
"2020-04-22","VIDELA","0","1","0","1"
"2020-04-22","VILLA ANA","0","0","1","1"
"2020-04-22","VILLA CAÑAS","0","1","0","1"
"2020-04-22","VILLA CONSTITUCION","9","24","1","34"
"2020-04-22","VILLA GOBERNADOR GALVEZ","2","81","7","90"
"2020-04-22","VILLA MINETTI","0","1","0","1"
"2020-04-22","VILLA MUGUETA","0","3","0","3"
"2020-04-22","VILLA OCAMPO","0","1","0","1"
"2020-04-22","WHEELWRIGHT","0","2","0","2"
"2020-04-22","ZAVALLA","0","1","0","1"
"2020-04-23","ACEBAL","0","2","0","2"
"2020-04-23","ALBARELLOS","0","1","0","1"
"2020-04-23","ALCORTA","0","2","0","2"
"2020-04-23","ALVAREZ","0","3","0","3"
"2020-04-23","ALVEAR","0","4","0","4"
"2020-04-23","ANGEL GALLARDO","0","4","0","4"
"2020-04-23","ARMSTRONG","2","7","0","9"
"2020-04-23","AROCENA","0","4","0","4"
"2020-04-23","ARROYO AGUIAR","0","1","0","1"
"2020-04-23","ARROYO LEYES","0","8","0","8"
"2020-04-23","ARROYO SECO","2","19","0","21"
"2020-04-23","ARRUFO","0","2","0","2"
"2020-04-23","ARTEAGA","0","1","0","1"
"2020-04-23","AVELLANEDA","0","9","2","11"
"2020-04-23","BARRANCAS","0","3","0","3"
"2020-04-23","BERAVEBU","0","1","0","1"
"2020-04-23","BERNARDO DE IRIGOYEN","0","1","0","1"
"2020-04-23","BIGAND","0","9","1","10"
"2020-04-23","BOMBAL","0","3","0","3"
"2020-04-23","BOUQUET","0","1","0","1"
"2020-04-23","CAFFERATA","0","1","0","1"
"2020-04-23","CALCHAQUI","0","3","0","3"
"2020-04-23","CAÑADA DE GOMEZ","1","19","0","20"
"2020-04-23","CAÑADA DEL UCLE","0","1","0","1"
"2020-04-23","CAPITAN BERMUDEZ","0","26","0","26"
"2020-04-23","CARCARAÑA","0","10","0","10"
"2020-04-23","CARLOS PELLEGRINI","0","2","0","2"
"2020-04-23","CARMEN","0","1","0","1"
"2020-04-23","CARRERAS","0","3","0","3"
"2020-04-23","CARRIZALES","0","1","0","1"
"2020-04-23","CASILDA","2","29","2","33"
"2020-04-23","CAYASTA","1","4","0","5"
"2020-04-23","CERES","0","14","0","14"
"2020-04-23","CHABAS","1","2","0","3"
"2020-04-23","CHAÑAR LADEADO","0","1","0","1"
"2020-04-23","CLASON","0","1","0","1"
"2020-04-23","COLONIA ROSA","0","1","0","1"
"2020-04-23","CORONDA","0","10","0","10"
"2020-04-23","CORONEL RODOLFO S. DOMINGUEZ","0","2","0","2"
"2020-04-23","CORREA","0","4","0","4"
"2020-04-23","DESVIO ARIJON","0","1","0","1"
"2020-04-23","DIAZ","0","1","0","1"
"2020-04-23","DIEGO DE ALVEAR","0","1","0","1"
"2020-04-23","ELORTONDO","4","5","0","9"
"2020-04-23","EL RABON","0","1","0","1"
"2020-04-23","EL TREBOL","0","2","0","2"
"2020-04-23","EMPALME VILLA CONSTITUCION","0","2","0","2"
"2020-04-23","ESPERANZA","1","21","1","23"
"2020-04-23","FIGHIERA","0","3","0","3"
"2020-04-23","FIRMAT","1","11","0","12"
"2020-04-23","FLORENCIA","0","2","0","2"
"2020-04-23","FRANCK","1","7","0","8"
"2020-04-23","FRAY LUIS BELTRAN","1","15","0","16"
"2020-04-23","FRONTERA","0","5","1","6"
"2020-04-23","FUENTES","0","2","0","2"
"2020-04-23","FUNES","5","32","1","38"
"2020-04-23","GABOTO","0","3","0","3"
"2020-04-23","GALVEZ","9","16","0","25"
"2020-04-23","GENERAL LAGOS","0","1","0","1"
"2020-04-23","GESSLER","0","0","1","1"
"2020-04-23","GOBERNADOR CRESPO","0","1","0","1"
"2020-04-23","GODOY","0","1","0","1"
"2020-04-23","GRANADERO BAIGORRIA","2","50","0","52"
"2020-04-23","HELVECIA","2","14","2","18"
"2020-04-23","HUMBERTO PRIMO","0","1","0","1"
"2020-04-23","HUMBOLDT","1","1","0","2"
"2020-04-23","IBARLUCEA","0","5","0","5"
"2020-04-23","JOSEFINA","0","2","0","2"
"2020-04-23","JUNCAL","0","1","0","1"
"2020-04-23","LA BRAVA","0","1","0","1"
"2020-04-23","LA CRIOLLA","0","1","0","1"
"2020-04-23","LAGUNA PAIVA","0","3","2","5"
"2020-04-23","LANTERI","0","1","0","1"
"2020-04-23","LAS PAREJAS","1","5","0","6"
"2020-04-23","LAS ROSAS","1","6","0","7"
"2020-04-23","LAS TOSCAS","0","3","0","3"
"2020-04-23","LA VANGUARDIA","0","1","0","1"
"2020-04-23","LEHMANN","0","1","0","1"
"2020-04-23","LLAMBI CAMPBELL","3","1","0","4"
"2020-04-23","LOPEZ","0","2","0","2"
"2020-04-23","LOS MOLINOS","0","1","0","1"
"2020-04-23","LOS QUIRQUINCHOS","0","1","0","1"
"2020-04-23","LUIS PALACIOS","0","1","0","1"
"2020-04-23","MACIEL","0","2","0","2"
"2020-04-23","MALABRIGO","0","1","0","1"
"2020-04-23","MARGARITA","0","3","0","3"
"2020-04-23","MARIA JUANA","0","2","0","2"
"2020-04-23","MARIA SUSANA","0","3","0","3"
"2020-04-23","MARIA TERESA","0","1","0","1"
"2020-04-23","MAXIMO PAZ","0","1","0","1"
"2020-04-23","MONJE","0","2","0","2"
"2020-04-23","MONTEFIORE","0","1","0","1"
"2020-04-23","MONTES DE OCA","0","2","0","2"
"2020-04-23","MONTE VERA","0","7","0","7"
"2020-04-23","MURPHY","0","2","1","3"
"2020-04-23","NELSON","0","2","1","3"
"2020-04-23","NUEVO TORINO","0","0","1","1"
"2020-04-23","OLIVEROS","4","9","0","13"
"2020-04-23","PAVON ARRIBA","0","1","0","1"
"2020-04-23","PEREZ","0","37","1","38"
"2020-04-23","PILAR","0","1","0","1"
"2020-04-23","PIÑERO","0","1","0","1"
"2020-04-23","PRESIDENTE ROCA","0","1","0","1"
"2020-04-23","PUEBLO ANDINO","2","2","0","4"
"2020-04-23","PUEBLO ESTHER","0","10","0","10"
"2020-04-23","PUEBLO IRIGOYEN","0","1","0","1"
"2020-04-23","PUERTO GENERAL SAN MARTIN","0","13","0","13"
"2020-04-23","PUERTO RECONQUISTA","0","1","0","1"
"2020-04-23","PUJATO","2","4","0","6"
"2020-04-23","RAFAELA","21","78","8","107"
"2020-04-23","RAMONA","0","2","0","2"
"2020-04-23","RECONQUISTA","0","27","6","33"
"2020-04-23","RECREO","0","12","0","12"
"2020-04-23","RICARDONE","0","3","1","4"
"2020-04-23","RINCON POTRERO","0","1","0","1"
"2020-04-23","ROLDAN","6","23","0","29"
"2020-04-23","ROMANG","0","1","0","1"
"2020-04-23","ROSARIO","97","1680","41","1818"
"2020-04-23","RUFINO","0","6","0","6"
"2020-04-23","SALTO GRANDE","0","2","0","2"
"2020-04-23","SAN ANTONIO DE OBLIGADO","0","1","0","1"
"2020-04-23","SAN CARLOS CENTRO","0","8","1","9"
"2020-04-23","SAN CARLOS SUD","1","0","0","1"
"2020-04-23","SAN CRISTOBAL","0","1","1","2"
"2020-04-23","SANCTI SPIRITU","0","0","1","1"
"2020-04-23","SAN EDUARDO","0","1","0","1"
"2020-04-23","SANFORD","0","1","0","1"
"2020-04-23","SAN FRANCISCO DE SANTA FE","0","1","0","1"
"2020-04-23","SAN GENARO","1","3","0","4"
"2020-04-23","SAN GUILLERMO","0","2","0","2"
"2020-04-23","SAN JAVIER","1","5","0","6"
"2020-04-23","SAN JERONIMO DEL SAUCE","0","1","0","1"
"2020-04-23","SAN JERONIMO NORTE","0","2","0","2"
"2020-04-23","SAN JERONIMO SUD","0","3","0","3"
"2020-04-23","SAN JORGE","0","7","1","8"
"2020-04-23","SAN JOSE DE LA ESQUINA","0","5","0","5"
"2020-04-23","SAN JOSE DEL RINCON","1","9","1","11"
"2020-04-23","SAN JUSTO","0","5","2","7"
"2020-04-23","SAN LORENZO","3","43","3","49"
"2020-04-23","SANTA CLARA DE BUENA VISTA","0","2","0","2"
"2020-04-23","SANTA FE","27","477","25","529"
"2020-04-23","SANTA ISABEL","0","2","1","3"
"2020-04-23","SANTA ROSA DE CALCHINES","0","2","1","3"
"2020-04-23","SANTO DOMINGO","0","1","0","1"
"2020-04-23","SANTO TOME","5","63","6","74"
"2020-04-23","SAN VICENTE","0","2","0","2"
"2020-04-23","SARGENTO CABRAL","0","1","0","1"
"2020-04-23","SARMIENTO","0","2","0","2"
"2020-04-23","SASTRE","0","2","0","2"
"2020-04-23","SAUCE VIEJO","1","15","0","16"
"2020-04-23","SERODINO","0","2","0","2"
"2020-04-23","SOLDINI","0","1","0","1"
"2020-04-23","SUARDI","0","2","0","2"
"2020-04-23","SUNCHALES","0","3","0","3"
"2020-04-23","SUSANA","0","1","0","1"
"2020-04-23","TACURAL","0","2","0","2"
"2020-04-23","TEODELINA","0","5","0","5"
"2020-04-23","TIMBUES","0","3","1","4"
"2020-04-23","TOSTADO","0","4","0","4"
"2020-04-23","TOTORAS","0","2","0","2"
"2020-04-23","VENADO TUERTO","11","53","14","78"
"2020-04-23","VERA","1","16","0","17"
"2020-04-23","VIDELA","0","1","0","1"
"2020-04-23","VILLA ANA","0","0","1","1"
"2020-04-23","VILLA CAÑAS","0","2","0","2"
"2020-04-23","VILLA CONSTITUCION","9","25","0","34"
"2020-04-23","VILLA GOBERNADOR GALVEZ","2","87","4","93"
"2020-04-23","VILLA MINETTI","0","1","0","1"
"2020-04-23","VILLA MUGUETA","0","3","0","3"
"2020-04-23","VILLA OCAMPO","0","1","0","1"
"2020-04-23","WHEELWRIGHT","0","2","0","2"
"2020-04-23","ZAVALLA","0","1","0","1"
"2020-04-24","ACEBAL","0","2","0","2"
"2020-04-24","ALBARELLOS","0","1","0","1"
"2020-04-24","ALCORTA","0","2","0","2"
"2020-04-24","ALVAREZ","0","3","0","3"
"2020-04-24","ALVEAR","0","4","0","4"
"2020-04-24","ANGEL GALLARDO","0","4","0","4"
"2020-04-24","ARMSTRONG","2","7","0","9"
"2020-04-24","AROCENA","0","4","0","4"
"2020-04-24","ARROYO AGUIAR","0","1","0","1"
"2020-04-24","ARROYO LEYES","0","8","0","8"
"2020-04-24","ARROYO SECO","2","20","0","22"
"2020-04-24","ARRUFO","0","2","0","2"
"2020-04-24","ARTEAGA","0","1","0","1"
"2020-04-24","AVELLANEDA","0","11","0","11"
"2020-04-24","BARRANCAS","0","3","0","3"
"2020-04-24","BERAVEBU","0","1","0","1"
"2020-04-24","BERNARDO DE IRIGOYEN","0","1","0","1"
"2020-04-24","BIGAND","0","10","0","10"
"2020-04-24","BOMBAL","0","3","0","3"
"2020-04-24","BOUQUET","0","1","0","1"
"2020-04-24","CAFFERATA","0","1","0","1"
"2020-04-24","CALCHAQUI","0","3","0","3"
"2020-04-24","CAÑADA DE GOMEZ","1","20","1","22"
"2020-04-24","CAÑADA DEL UCLE","0","1","0","1"
"2020-04-24","CAPITAN BERMUDEZ","1","27","0","28"
"2020-04-24","CARCARAÑA","0","10","0","10"
"2020-04-24","CARLOS PELLEGRINI","0","2","0","2"
"2020-04-24","CARMEN","0","1","0","1"
"2020-04-24","CARRERAS","0","3","0","3"
"2020-04-24","CARRIZALES","0","1","0","1"
"2020-04-24","CASILDA","2","31","2","35"
"2020-04-24","CAYASTA","1","4","0","5"
"2020-04-24","CERES","0","14","0","14"
"2020-04-24","CHABAS","1","2","0","3"
"2020-04-24","CHAÑAR LADEADO","0","1","0","1"
"2020-04-24","CHOVET","0","1","0","1"
"2020-04-24","CLASON","0","1","0","1"
"2020-04-24","COLONIA ROSA","0","1","0","1"
"2020-04-24","CORONDA","0","10","0","10"
"2020-04-24","CORONEL RODOLFO S. DOMINGUEZ","0","2","0","2"
"2020-04-24","CORREA","0","4","0","4"
"2020-04-24","DESVIO ARIJON","0","1","0","1"
"2020-04-24","DIAZ","0","1","0","1"
"2020-04-24","DIEGO DE ALVEAR","0","1","0","1"
"2020-04-24","ELORTONDO","4","5","0","9"
"2020-04-24","EL RABON","0","1","0","1"
"2020-04-24","EL TREBOL","0","2","0","2"
"2020-04-24","EMPALME VILLA CONSTITUCION","0","2","0","2"
"2020-04-24","ESPERANZA","1","21","1","23"
"2020-04-24","FIGHIERA","0","3","0","3"
"2020-04-24","FIRMAT","1","13","0","14"
"2020-04-24","FLORENCIA","0","2","0","2"
"2020-04-24","FRANCK","1","7","0","8"
"2020-04-24","FRAY LUIS BELTRAN","1","15","0","16"
"2020-04-24","FRONTERA","0","6","0","6"
"2020-04-24","FUENTES","0","2","0","2"
"2020-04-24","FUNES","5","34","4","43"
"2020-04-24","GABOTO","0","3","0","3"
"2020-04-24","GALVEZ","9","16","0","25"
"2020-04-24","GENERAL LAGOS","0","1","1","2"
"2020-04-24","GESSLER","0","0","1","1"
"2020-04-24","GOBERNADOR CRESPO","0","1","0","1"
"2020-04-24","GODOY","0","1","0","1"
"2020-04-24","GRANADERO BAIGORRIA","2","50","0","52"
"2020-04-24","HELVECIA","2","15","1","18"
"2020-04-24","HUGHES","0","2","0","2"
"2020-04-24","HUMBERTO PRIMO","0","1","0","1"
"2020-04-24","HUMBOLDT","1","1","0","2"
"2020-04-24","IBARLUCEA","0","5","0","5"
"2020-04-24","JOSEFINA","0","2","0","2"
"2020-04-24","JUAN B. MOLINA","0","1","0","1"
"2020-04-24","JUNCAL","0","1","0","1"
"2020-04-24","LA BRAVA","0","1","0","1"
"2020-04-24","LA CRIOLLA","0","1","0","1"
"2020-04-24","LAGUNA PAIVA","0","5","0","5"
"2020-04-24","LANTERI","0","1","0","1"
"2020-04-24","LAS PAREJAS","1","5","0","6"
"2020-04-24","LAS ROSAS","1","6","0","7"
"2020-04-24","LAS TOSCAS","0","3","0","3"
"2020-04-24","LA VANGUARDIA","0","1","0","1"
"2020-04-24","LEHMANN","0","1","0","1"
"2020-04-24","LLAMBI CAMPBELL","3","1","0","4"
"2020-04-24","LOPEZ","0","2","0","2"
"2020-04-24","LOS MOLINOS","0","1","0","1"
"2020-04-24","LOS QUIRQUINCHOS","0","1","0","1"
"2020-04-24","LUIS PALACIOS","0","1","0","1"
"2020-04-24","MACIEL","0","2","0","2"
"2020-04-24","MALABRIGO","0","1","0","1"
"2020-04-24","MARGARITA","0","3","0","3"
"2020-04-24","MARIA JUANA","0","2","0","2"
"2020-04-24","MARIA SUSANA","0","3","0","3"
"2020-04-24","MARIA TERESA","0","2","0","2"
"2020-04-24","MAXIMO PAZ","0","1","0","1"
"2020-04-24","MELINCUE","0","1","0","1"
"2020-04-24","MONJE","0","2","0","2"
"2020-04-24","MONTEFIORE","0","1","0","1"
"2020-04-24","MONTES DE OCA","0","2","0","2"
"2020-04-24","MONTE VERA","0","7","0","7"
"2020-04-24","MURPHY","0","3","0","3"
"2020-04-24","NELSON","0","3","0","3"
"2020-04-24","NUEVO TORINO","0","1","0","1"
"2020-04-24","OLIVEROS","4","9","0","13"
"2020-04-24","PAVON ARRIBA","0","1","0","1"
"2020-04-24","PEREZ","0","37","1","38"
"2020-04-24","PILAR","0","1","0","1"
"2020-04-24","PIÑERO","0","1","0","1"
"2020-04-24","PRESIDENTE ROCA","0","1","0","1"
"2020-04-24","PUEBLO ANDINO","2","2","0","4"
"2020-04-24","PUEBLO ESTHER","0","11","0","11"
"2020-04-24","PUEBLO IRIGOYEN","0","1","0","1"
"2020-04-24","PUERTO GENERAL SAN MARTIN","0","13","0","13"
"2020-04-24","PUERTO RECONQUISTA","0","1","0","1"
"2020-04-24","PUJATO","2","4","0","6"
"2020-04-24","RAFAELA","21","83","5","109"
"2020-04-24","RAMONA","0","2","0","2"
"2020-04-24","RECONQUISTA","0","32","2","34"
"2020-04-24","RECREO","0","12","1","13"
"2020-04-24","RICARDONE","0","4","0","4"
"2020-04-24","RINCON POTRERO","0","1","0","1"
"2020-04-24","ROLDAN","6","24","0","30"
"2020-04-24","ROMANG","0","1","0","1"
"2020-04-24","ROSARIO","97","1782","60","1939"
"2020-04-24","RUFINO","0","6","0","6"
"2020-04-24","SALTO GRANDE","0","2","0","2"
"2020-04-24","SAN ANTONIO DE OBLIGADO","0","1","0","1"
"2020-04-24","SAN CARLOS CENTRO","0","9","0","9"
"2020-04-24","SAN CARLOS SUD","1","0","0","1"
"2020-04-24","SAN CRISTOBAL","0","2","0","2"
"2020-04-24","SANCTI SPIRITU","1","0","0","1"
"2020-04-24","SAN EDUARDO","0","1","0","1"
"2020-04-24","SANFORD","0","1","0","1"
"2020-04-24","SAN FRANCISCO DE SANTA FE","0","1","0","1"
"2020-04-24","SAN GENARO","1","3","0","4"
"2020-04-24","SAN GREGORIO","0","1","0","1"
"2020-04-24","SAN GUILLERMO","0","2","0","2"
"2020-04-24","SAN JAVIER","1","5","0","6"
"2020-04-24","SAN JERONIMO DEL SAUCE","0","1","0","1"
"2020-04-24","SAN JERONIMO NORTE","0","2","0","2"
"2020-04-24","SAN JERONIMO SUD","0","3","0","3"
"2020-04-24","SAN JORGE","0","8","0","8"
"2020-04-24","SAN JOSE DE LA ESQUINA","0","5","0","5"
"2020-04-24","SAN JOSE DEL RINCON","1","9","1","11"
"2020-04-24","SAN JUSTO","0","6","1","7"
"2020-04-24","SAN LORENZO","3","44","5","52"
"2020-04-24","SANTA CLARA DE BUENA VISTA","0","2","0","2"
"2020-04-24","SANTA FE","27","488","27","542"
"2020-04-24","SANTA ISABEL","0","5","1","6"
"2020-04-24","SANTA ROSA DE CALCHINES","0","3","0","3"
"2020-04-24","SANTO DOMINGO","0","1","0","1"
"2020-04-24","SANTO TOME","5","69","1","75"
"2020-04-24","SAN VICENTE","0","2","0","2"
"2020-04-24","SARGENTO CABRAL","0","1","0","1"
"2020-04-24","SARMIENTO","0","2","0","2"
"2020-04-24","SASTRE","0","2","0","2"
"2020-04-24","SAUCE VIEJO","1","15","1","17"
"2020-04-24","SERODINO","0","2","0","2"
"2020-04-24","SOLDINI","0","1","0","1"
"2020-04-24","SUARDI","0","2","0","2"
"2020-04-24","SUNCHALES","0","3","0","3"
"2020-04-24","SUSANA","0","1","0","1"
"2020-04-24","TACURAL","0","2","0","2"
"2020-04-24","TEODELINA","0","7","0","7"
"2020-04-24","TIMBUES","0","3","1","4"
"2020-04-24","TOSTADO","0","4","0","4"
"2020-04-24","TOTORAS","0","3","0","3"
"2020-04-24","VENADO TUERTO","12","77","6","95"
"2020-04-24","VERA","1","16","0","17"
"2020-04-24","VIDELA","0","1","0","1"
"2020-04-24","VILLA ANA","0","1","0","1"
"2020-04-24","VILLA CAÑAS","0","2","0","2"
"2020-04-24","VILLA CONSTITUCION","9","26","0","35"
"2020-04-24","VILLA GOBERNADOR GALVEZ","2","91","7","100"
"2020-04-24","VILLA MINETTI","0","1","1","2"
"2020-04-24","VILLA MUGUETA","0","3","0","3"
"2020-04-24","VILLA OCAMPO","0","1","0","1"
"2020-04-24","WHEELWRIGHT","0","4","0","4"
"2020-04-24","ZAVALLA","0","1","0","1"
"2020-04-25","ACEBAL","0","2","0","2"
"2020-04-25","ALBARELLOS","0","1","0","1"
"2020-04-25","ALCORTA","0","2","0","2"
"2020-04-25","ALVAREZ","0","3","0","3"
"2020-04-25","ALVEAR","0","4","0","4"
"2020-04-25","ANGEL GALLARDO","0","4","0","4"
"2020-04-25","ARMSTRONG","2","7","0","9"
"2020-04-25","AROCENA","0","4","0","4"
"2020-04-25","ARROYO AGUIAR","0","1","0","1"
"2020-04-25","ARROYO LEYES","0","8","0","8"
"2020-04-25","ARROYO SECO","2","21","1","24"
"2020-04-25","ARRUFO","0","2","0","2"
"2020-04-25","ARTEAGA","0","1","0","1"
"2020-04-25","AVELLANEDA","0","11","0","11"
"2020-04-25","BARRANCAS","0","3","0","3"
"2020-04-25","BERAVEBU","0","1","0","1"
"2020-04-25","BERNARDO DE IRIGOYEN","0","1","0","1"
"2020-04-25","BIGAND","0","10","1","11"
"2020-04-25","BOMBAL","0","3","0","3"
"2020-04-25","BOUQUET","0","1","0","1"
"2020-04-25","CAFFERATA","0","1","0","1"
"2020-04-25","CALCHAQUI","0","3","0","3"
"2020-04-25","CAÑADA DE GOMEZ","1","20","1","22"
"2020-04-25","CAÑADA DEL UCLE","0","1","0","1"
"2020-04-25","CAPITAN BERMUDEZ","1","27","1","29"
"2020-04-25","CARCARAÑA","0","10","0","10"
"2020-04-25","CARLOS PELLEGRINI","0","2","0","2"
"2020-04-25","CARMEN","0","1","0","1"
"2020-04-25","CARRERAS","0","3","0","3"
"2020-04-25","CARRIZALES","0","1","0","1"
"2020-04-25","CASILDA","2","31","3","36"
"2020-04-25","CAYASTA","1","4","0","5"
"2020-04-25","CERES","0","14","0","14"
"2020-04-25","CHABAS","1","2","0","3"
"2020-04-25","CHAÑAR LADEADO","0","1","0","1"
"2020-04-25","CHOVET","0","1","0","1"
"2020-04-25","CLASON","0","1","0","1"
"2020-04-25","COLONIA ROSA","0","1","0","1"
"2020-04-25","CORONDA","0","10","0","10"
"2020-04-25","CORONEL RODOLFO S. DOMINGUEZ","0","2","0","2"
"2020-04-25","CORREA","0","5","0","5"
"2020-04-25","DESVIO ARIJON","0","1","0","1"
"2020-04-25","DIAZ","0","1","0","1"
"2020-04-25","DIEGO DE ALVEAR","0","1","0","1"
"2020-04-25","ELORTONDO","4","5","0","9"
"2020-04-25","EL RABON","0","1","0","1"
"2020-04-25","EL TREBOL","0","2","0","2"
"2020-04-25","EMPALME VILLA CONSTITUCION","0","2","0","2"
"2020-04-25","ESPERANZA","1","22","1","24"
"2020-04-25","FIGHIERA","0","3","0","3"
"2020-04-25","FIRMAT","1","13","0","14"
"2020-04-25","FLORENCIA","0","2","0","2"
"2020-04-25","FRANCK","1","7","0","8"
"2020-04-25","FRAY LUIS BELTRAN","3","18","0","21"
"2020-04-25","FRONTERA","0","6","0","6"
"2020-04-25","FUENTES","0","2","0","2"
"2020-04-25","FUNES","5","37","2","44"
"2020-04-25","GABOTO","0","3","0","3"
"2020-04-25","GALVEZ","9","16","0","25"
"2020-04-25","GENERAL LAGOS","0","1","1","2"
"2020-04-25","GESSLER","0","0","1","1"
"2020-04-25","GOBERNADOR CRESPO","0","1","0","1"
"2020-04-25","GODOY","0","1","0","1"
"2020-04-25","GRANADERO BAIGORRIA","2","50","1","53"
"2020-04-25","HELVECIA","2","15","1","18"
"2020-04-25","HUGHES","0","2","1","3"
"2020-04-25","HUMBERTO PRIMO","0","1","0","1"
"2020-04-25","HUMBOLDT","1","1","0","2"
"2020-04-25","IBARLUCEA","0","6","0","6"
"2020-04-25","JOSEFINA","0","2","0","2"
"2020-04-25","JUAN B. MOLINA","0","1","0","1"
"2020-04-25","JUNCAL","0","1","0","1"
"2020-04-25","LA BRAVA","0","1","0","1"
"2020-04-25","LA CRIOLLA","0","1","0","1"
"2020-04-25","LAGUNA PAIVA","0","5","0","5"
"2020-04-25","LANTERI","0","1","0","1"
"2020-04-25","LAS PAREJAS","1","5","1","7"
"2020-04-25","LAS ROSAS","1","6","0","7"
"2020-04-25","LAS TOSCAS","0","3","0","3"
"2020-04-25","LA VANGUARDIA","0","1","0","1"
"2020-04-25","LEHMANN","0","1","0","1"
"2020-04-25","LLAMBI CAMPBELL","3","1","0","4"
"2020-04-25","LOPEZ","0","2","0","2"
"2020-04-25","LOS MOLINOS","0","1","0","1"
"2020-04-25","LOS QUIRQUINCHOS","0","2","0","2"
"2020-04-25","LUIS PALACIOS","0","1","1","2"
"2020-04-25","MACIEL","0","2","0","2"
"2020-04-25","MALABRIGO","0","1","0","1"
"2020-04-25","MARGARITA","0","3","0","3"
"2020-04-25","MARIA JUANA","0","2","0","2"
"2020-04-25","MARIA SUSANA","0","3","0","3"
"2020-04-25","MARIA TERESA","0","2","0","2"
"2020-04-25","MAXIMO PAZ","0","1","0","1"
"2020-04-25","MELINCUE","0","1","0","1"
"2020-04-25","MONJE","0","2","0","2"
"2020-04-25","MONTEFIORE","0","1","0","1"
"2020-04-25","MONTES DE OCA","0","2","0","2"
"2020-04-25","MONTE VERA","0","7","0","7"
"2020-04-25","MURPHY","0","3","0","3"
"2020-04-25","NELSON","0","3","0","3"
"2020-04-25","NUEVO TORINO","0","1","0","1"
"2020-04-25","OLIVEROS","4","9","0","13"
"2020-04-25","PAVON ARRIBA","0","1","0","1"
"2020-04-25","PEREZ","0","37","2","39"
"2020-04-25","PIAMONTE","0","1","0","1"
"2020-04-25","PILAR","0","1","0","1"
"2020-04-25","PIÑERO","0","1","0","1"
"2020-04-25","PRESIDENTE ROCA","0","1","0","1"
"2020-04-25","PUEBLO ANDINO","2","2","0","4"
"2020-04-25","PUEBLO ESTHER","0","11","0","11"
"2020-04-25","PUEBLO IRIGOYEN","0","1","0","1"
"2020-04-25","PUERTO GENERAL SAN MARTIN","0","14","1","15"
"2020-04-25","PUERTO RECONQUISTA","0","1","0","1"
"2020-04-25","PUJATO","2","4","1","7"
"2020-04-25","RAFAELA","21","83","7","111"
"2020-04-25","RAMONA","0","2","0","2"
"2020-04-25","RECONQUISTA","0","32","2","34"
"2020-04-25","RECREO","0","12","1","13"
"2020-04-25","RICARDONE","0","4","0","4"
"2020-04-25","RINCON POTRERO","0","1","0","1"
"2020-04-25","ROLDAN","6","24","0","30"
"2020-04-25","ROMANG","0","1","0","1"
"2020-04-25","ROSARIO","98","1851","95","2044"
"2020-04-25","RUFINO","0","7","1","8"
"2020-04-25","SALTO GRANDE","0","2","0","2"
"2020-04-25","SAN ANTONIO DE OBLIGADO","0","1","0","1"
"2020-04-25","SAN CARLOS CENTRO","0","9","0","9"
"2020-04-25","SAN CARLOS SUD","1","0","0","1"
"2020-04-25","SAN CRISTOBAL","0","2","0","2"
"2020-04-25","SANCTI SPIRITU","1","0","0","1"
"2020-04-25","SAN EDUARDO","0","1","4","5"
"2020-04-25","SANFORD","0","1","0","1"
"2020-04-25","SAN FRANCISCO DE SANTA FE","0","1","0","1"
"2020-04-25","SAN GENARO","1","3","0","4"
"2020-04-25","SAN GREGORIO","0","1","0","1"
"2020-04-25","SAN GUILLERMO","0","2","1","3"
"2020-04-25","SAN JAVIER","1","5","2","8"
"2020-04-25","SAN JERONIMO DEL SAUCE","0","1","0","1"
"2020-04-25","SAN JERONIMO NORTE","0","2","0","2"
"2020-04-25","SAN JERONIMO SUD","0","3","0","3"
"2020-04-25","SAN JORGE","0","8","0","8"
"2020-04-25","SAN JOSE DE LA ESQUINA","0","5","0","5"
"2020-04-25","SAN JOSE DEL RINCON","1","9","1","11"
"2020-04-25","SAN JUSTO","0","7","0","7"
"2020-04-25","SAN LORENZO","3","45","5","53"
"2020-04-25","SANTA CLARA DE BUENA VISTA","0","2","0","2"
"2020-04-25","SANTA FE","27","488","38","553"
"2020-04-25","SANTA ISABEL","0","5","1","6"
"2020-04-25","SANTA ROSA DE CALCHINES","0","3","0","3"
"2020-04-25","SANTO DOMINGO","0","1","0","1"
"2020-04-25","SANTO TOME","5","70","3","78"
"2020-04-25","SAN VICENTE","0","2","0","2"
"2020-04-25","SARGENTO CABRAL","0","1","0","1"
"2020-04-25","SARMIENTO","0","2","0","2"
"2020-04-25","SASTRE","0","2","0","2"
"2020-04-25","SAUCE VIEJO","1","15","1","17"
"2020-04-25","SERODINO","0","2","0","2"
"2020-04-25","SOLDINI","0","1","0","1"
"2020-04-25","SUARDI","0","2","0","2"
"2020-04-25","SUNCHALES","0","3","1","4"
"2020-04-25","SUSANA","0","1","0","1"
"2020-04-25","TACURAL","0","2","0","2"
"2020-04-25","TEODELINA","0","7","0","7"
"2020-04-25","TIMBUES","0","3","1","4"
"2020-04-25","TOSTADO","0","4","0","4"
"2020-04-25","TOTORAS","0","3","0","3"
"2020-04-25","VENADO TUERTO","12","77","9","98"
"2020-04-25","VERA","1","16","0","17"
"2020-04-25","VIDELA","0","1","0","1"
"2020-04-25","VILLA ANA","0","1","0","1"
"2020-04-25","VILLA CAÑAS","0","2","0","2"
"2020-04-25","VILLA CONSTITUCION","9","26","0","35"
"2020-04-25","VILLA GOBERNADOR GALVEZ","2","97","5","104"
"2020-04-25","VILLA MINETTI","0","1","2","3"
"2020-04-25","VILLA MUGUETA","0","3","0","3"
"2020-04-25","VILLA OCAMPO","0","1","0","1"
"2020-04-25","WHEELWRIGHT","0","4","0","4"
"2020-04-25","ZAVALLA","0","1","0","1"
"2020-04-26","ACEBAL","0","2","0","2"
"2020-04-26","ALBARELLOS","0","1","0","1"
"2020-04-26","ALCORTA","0","2","0","2"
"2020-04-26","ALVAREZ","0","3","0","3"
"2020-04-26","ALVEAR","0","4","0","4"
"2020-04-26","ANGEL GALLARDO","0","4","0","4"
"2020-04-26","ARMSTRONG","2","8","0","10"
"2020-04-26","AROCENA","0","4","0","4"
"2020-04-26","ARROYO AGUIAR","0","1","0","1"
"2020-04-26","ARROYO LEYES","0","8","0","8"
"2020-04-26","ARROYO SECO","2","23","0","25"
"2020-04-26","ARRUFO","0","2","0","2"
"2020-04-26","ARTEAGA","0","1","0","1"
"2020-04-26","AVELLANEDA","0","11","0","11"
"2020-04-26","BARRANCAS","0","3","0","3"
"2020-04-26","BERAVEBU","0","1","0","1"
"2020-04-26","BERNARDO DE IRIGOYEN","0","1","0","1"
"2020-04-26","BIGAND","0","11","0","11"
"2020-04-26","BOMBAL","0","3","0","3"
"2020-04-26","BOUQUET","0","1","0","1"
"2020-04-26","CAFFERATA","0","1","0","1"
"2020-04-26","CALCHAQUI","0","3","0","3"
"2020-04-26","CAÑADA DE GOMEZ","1","21","0","22"
"2020-04-26","CAÑADA DEL UCLE","0","1","0","1"
"2020-04-26","CAPITAN BERMUDEZ","1","28","0","29"
"2020-04-26","CARCARAÑA","0","10","0","10"
"2020-04-26","CARLOS PELLEGRINI","0","2","0","2"
"2020-04-26","CARMEN","0","1","0","1"
"2020-04-26","CARRERAS","0","3","0","3"
"2020-04-26","CARRIZALES","0","1","0","1"
"2020-04-26","CASILDA","2","33","2","37"
"2020-04-26","CAYASTA","1","4","0","5"
"2020-04-26","CERES","0","14","0","14"
"2020-04-26","CHABAS","1","2","0","3"
"2020-04-26","CHAÑAR LADEADO","0","1","0","1"
"2020-04-26","CHOVET","0","1","0","1"
"2020-04-26","CLASON","0","1","0","1"
"2020-04-26","COLONIA ROSA","0","1","0","1"
"2020-04-26","CORONDA","0","10","0","10"
"2020-04-26","CORONEL ARNOLD","0","1","0","1"
"2020-04-26","CORONEL RODOLFO S. DOMINGUEZ","0","2","0","2"
"2020-04-26","CORREA","0","5","0","5"
"2020-04-26","DESVIO ARIJON","0","1","0","1"
"2020-04-26","DIAZ","0","1","0","1"
"2020-04-26","DIEGO DE ALVEAR","0","1","0","1"
"2020-04-26","ELORTONDO","4","5","0","9"
"2020-04-26","EL RABON","0","1","0","1"
"2020-04-26","EL TREBOL","0","2","0","2"
"2020-04-26","EMPALME VILLA CONSTITUCION","0","2","0","2"
"2020-04-26","ESPERANZA","1","22","1","24"
"2020-04-26","FIGHIERA","0","3","0","3"
"2020-04-26","FIRMAT","1","13","0","14"
"2020-04-26","FLORENCIA","0","2","0","2"
"2020-04-26","FRANCK","1","7","0","8"
"2020-04-26","FRAY LUIS BELTRAN","3","18","0","21"
"2020-04-26","FRONTERA","0","6","0","6"
"2020-04-26","FUENTES","0","2","0","2"
"2020-04-26","FUNES","5","38","1","44"
"2020-04-26","GABOTO","0","3","0","3"
"2020-04-26","GALVEZ","9","16","0","25"
"2020-04-26","GENERAL LAGOS","0","2","1","3"
"2020-04-26","GESSLER","0","0","1","1"
"2020-04-26","GOBERNADOR CRESPO","0","1","0","1"
"2020-04-26","GODOY","0","1","0","1"
"2020-04-26","GRANADERO BAIGORRIA","2","51","0","53"
"2020-04-26","HELVECIA","2","15","1","18"
"2020-04-26","HUGHES","0","3","0","3"
"2020-04-26","HUMBERTO PRIMO","0","1","0","1"
"2020-04-26","HUMBOLDT","1","1","0","2"
"2020-04-26","IBARLUCEA","0","6","0","6"
"2020-04-26","JOSEFINA","0","2","0","2"
"2020-04-26","JUAN B. MOLINA","0","1","0","1"
"2020-04-26","JUNCAL","0","1","0","1"
"2020-04-26","LA BRAVA","0","1","0","1"
"2020-04-26","LA CRIOLLA","0","1","0","1"
"2020-04-26","LAGUNA PAIVA","0","5","0","5"
"2020-04-26","LANTERI","0","1","0","1"
"2020-04-26","LAS PAREJAS","1","6","0","7"
"2020-04-26","LAS ROSAS","1","6","0","7"
"2020-04-26","LAS TOSCAS","0","3","0","3"
"2020-04-26","LA VANGUARDIA","0","1","0","1"
"2020-04-26","LEHMANN","0","1","0","1"
"2020-04-26","LLAMBI CAMPBELL","3","1","0","4"
"2020-04-26","LOPEZ","0","2","0","2"
"2020-04-26","LOS MOLINOS","0","1","0","1"
"2020-04-26","LOS QUIRQUINCHOS","0","2","0","2"
"2020-04-26","LUIS PALACIOS","0","2","0","2"
"2020-04-26","MACIEL","0","2","0","2"
"2020-04-26","MALABRIGO","0","1","0","1"
"2020-04-26","MARGARITA","0","3","0","3"
"2020-04-26","MARIA JUANA","0","2","0","2"
"2020-04-26","MARIA SUSANA","0","3","0","3"
"2020-04-26","MARIA TERESA","0","2","0","2"
"2020-04-26","MAXIMO PAZ","0","1","0","1"
"2020-04-26","MELINCUE","0","1","0","1"
"2020-04-26","MONJE","0","2","0","2"
"2020-04-26","MONTEFIORE","0","1","0","1"
"2020-04-26","MONTES DE OCA","0","2","0","2"
"2020-04-26","MONTE VERA","0","7","0","7"
"2020-04-26","MURPHY","0","3","0","3"
"2020-04-26","NELSON","0","3","0","3"
"2020-04-26","NUEVO TORINO","0","1","0","1"
"2020-04-26","OLIVEROS","4","9","0","13"
"2020-04-26","PAVON","0","1","0","1"
"2020-04-26","PAVON ARRIBA","0","1","0","1"
"2020-04-26","PEREZ","0","39","1","40"
"2020-04-26","PIAMONTE","0","1","0","1"
"2020-04-26","PILAR","0","1","0","1"
"2020-04-26","PIÑERO","0","1","0","1"
"2020-04-26","PRESIDENTE ROCA","0","1","0","1"
"2020-04-26","PUEBLO ANDINO","2","2","0","4"
"2020-04-26","PUEBLO ESTHER","0","12","0","12"
"2020-04-26","PUEBLO IRIGOYEN","0","1","0","1"
"2020-04-26","PUERTO GENERAL SAN MARTIN","0","15","0","15"
"2020-04-26","PUERTO RECONQUISTA","0","1","0","1"
"2020-04-26","PUJATO","2","4","1","7"
"2020-04-26","RAFAELA","21","86","4","111"
"2020-04-26","RAMONA","0","2","0","2"
"2020-04-26","RECONQUISTA","0","32","2","34"
"2020-04-26","RECREO","0","13","0","13"
"2020-04-26","RICARDONE","0","4","0","4"
"2020-04-26","RINCON POTRERO","0","1","0","1"
"2020-04-26","ROLDAN","6","24","0","30"
"2020-04-26","ROMANG","0","1","0","1"
"2020-04-26","ROSARIO","98","1956","30","2084"
"2020-04-26","RUFINO","0","8","0","8"
"2020-04-26","SALTO GRANDE","0","2","0","2"
"2020-04-26","SAN ANTONIO DE OBLIGADO","0","1","0","1"
"2020-04-26","SAN CARLOS CENTRO","0","9","0","9"
"2020-04-26","SAN CARLOS SUD","1","0","0","1"
"2020-04-26","SAN CRISTOBAL","0","2","0","2"
"2020-04-26","SANCTI SPIRITU","1","0","0","1"
"2020-04-26","SAN EDUARDO","0","5","0","5"
"2020-04-26","SANFORD","0","1","0","1"
"2020-04-26","SAN FRANCISCO DE SANTA FE","0","1","0","1"
"2020-04-26","SAN GENARO","1","3","0","4"
"2020-04-26","SAN GREGORIO","0","1","0","1"
"2020-04-26","SAN GUILLERMO","0","3","0","3"
"2020-04-26","SAN JAVIER","1","6","1","8"
"2020-04-26","SAN JERONIMO DEL SAUCE","0","1","0","1"
"2020-04-26","SAN JERONIMO NORTE","0","2","0","2"
"2020-04-26","SAN JERONIMO SUD","0","3","0","3"
"2020-04-26","SAN JORGE","0","8","0","8"
"2020-04-26","SAN JOSE DE LA ESQUINA","0","5","0","5"
"2020-04-26","SAN JOSE DEL RINCON","1","9","1","11"
"2020-04-26","SAN JUSTO","0","7","0","7"
"2020-04-26","SAN LORENZO","3","48","3","54"
"2020-04-26","SANTA CLARA DE BUENA VISTA","0","2","0","2"
"2020-04-26","SANTA FE","27","506","20","553"
"2020-04-26","SANTA ISABEL","0","5","1","6"
"2020-04-26","SANTA ROSA DE CALCHINES","0","3","0","3"
"2020-04-26","SANTO DOMINGO","0","1","0","1"
"2020-04-26","SANTO TOME","5","71","2","78"
"2020-04-26","SAN VICENTE","0","2","0","2"
"2020-04-26","SARGENTO CABRAL","0","1","0","1"
"2020-04-26","SARMIENTO","0","2","0","2"
"2020-04-26","SASTRE","0","2","0","2"
"2020-04-26","SAUCE VIEJO","1","16","0","17"
"2020-04-26","SERODINO","0","2","0","2"
"2020-04-26","SOLDINI","0","1","0","1"
"2020-04-26","SUARDI","0","2","0","2"
"2020-04-26","SUNCHALES","0","4","0","4"
"2020-04-26","SUSANA","0","1","0","1"
"2020-04-26","TACURAL","0","2","0","2"
"2020-04-26","TEODELINA","0","7","0","7"
"2020-04-26","TIMBUES","0","3","1","4"
"2020-04-26","TOSTADO","0","4","0","4"
"2020-04-26","TOTORAS","0","3","0","3"
"2020-04-26","VENADO TUERTO","12","80","6","98"
"2020-04-26","VERA","1","16","0","17"
"2020-04-26","VIDELA","0","1","0","1"
"2020-04-26","VILLA ANA","0","1","0","1"
"2020-04-26","VILLA CAÑAS","0","2","0","2"
"2020-04-26","VILLA CONSTITUCION","9","27","0","36"
"2020-04-26","VILLA GOBERNADOR GALVEZ","2","98","5","105"
"2020-04-26","VILLA MINETTI","0","3","0","3"
"2020-04-26","VILLA MUGUETA","0","3","0","3"
"2020-04-26","VILLA OCAMPO","0","1","0","1"
"2020-04-26","WHEELWRIGHT","0","4","0","4"
"2020-04-26","ZAVALLA","0","1","0","1"
"2020-04-27","ACEBAL","0","2","0","2"
"2020-04-27","ALBARELLOS","0","1","0","1"
"2020-04-27","ALCORTA","0","2","1","3"
"2020-04-27","ALVAREZ","0","3","1","4"
"2020-04-27","ALVEAR","0","4","0","4"
"2020-04-27","ANGEL GALLARDO","0","4","0","4"
"2020-04-27","ARMSTRONG","2","9","0","11"
"2020-04-27","AROCENA","0","4","0","4"
"2020-04-27","ARROYO AGUIAR","0","1","0","1"
"2020-04-27","ARROYO LEYES","0","8","0","8"
"2020-04-27","ARROYO SECO","2","23","0","25"
"2020-04-27","ARRUFO","0","2","0","2"
"2020-04-27","ARTEAGA","0","1","0","1"
"2020-04-27","AVELLANEDA","0","11","1","12"
"2020-04-27","BARRANCAS","0","3","0","3"
"2020-04-27","BERAVEBU","0","1","0","1"
"2020-04-27","BERNARDO DE IRIGOYEN","0","1","0","1"
"2020-04-27","BIGAND","0","11","0","11"
"2020-04-27","BOMBAL","0","3","0","3"
"2020-04-27","BOUQUET","0","1","0","1"
"2020-04-27","CAFFERATA","0","1","0","1"
"2020-04-27","CALCHAQUI","0","3","0","3"
"2020-04-27","CAÑADA DE GOMEZ","1","21","1","23"
"2020-04-27","CAÑADA DEL UCLE","0","1","0","1"
"2020-04-27","CAPITAN BERMUDEZ","1","28","2","31"
"2020-04-27","CARCARAÑA","0","10","0","10"
"2020-04-27","CARLOS PELLEGRINI","0","2","0","2"
"2020-04-27","CARMEN","0","1","0","1"
"2020-04-27","CARRERAS","0","3","0","3"
"2020-04-27","CARRIZALES","0","1","0","1"
"2020-04-27","CASILDA","2","33","2","37"
"2020-04-27","CAYASTA","1","4","0","5"
"2020-04-27","CERES","0","14","1","15"
"2020-04-27","CHABAS","1","2","0","3"
"2020-04-27","CHAÑAR LADEADO","0","1","0","1"
"2020-04-27","CHOVET","0","1","0","1"
"2020-04-27","CLASON","0","1","0","1"
"2020-04-27","COLONIA ROSA","0","1","0","1"
"2020-04-27","CORONDA","0","10","0","10"
"2020-04-27","CORONEL ARNOLD","0","1","0","1"
"2020-04-27","CORONEL RODOLFO S. DOMINGUEZ","0","2","0","2"
"2020-04-27","CORREA","0","5","0","5"
"2020-04-27","DESVIO ARIJON","0","1","0","1"
"2020-04-27","DIAZ","0","1","0","1"
"2020-04-27","DIEGO DE ALVEAR","0","1","0","1"
"2020-04-27","ELORTONDO","4","6","0","10"
"2020-04-27","EL RABON","0","1","0","1"
"2020-04-27","EL TREBOL","0","2","1","3"
"2020-04-27","EMPALME VILLA CONSTITUCION","0","2","0","2"
"2020-04-27","ESPERANZA","1","22","3","26"
"2020-04-27","FIGHIERA","0","3","0","3"
"2020-04-27","FIRMAT","1","13","1","15"
"2020-04-27","FLORENCIA","0","2","1","3"
"2020-04-27","FRANCK","1","7","0","8"
"2020-04-27","FRAY LUIS BELTRAN","3","18","2","23"
"2020-04-27","FRONTERA","0","6","0","6"
"2020-04-27","FUENTES","0","2","0","2"
"2020-04-27","FUNES","5","39","1","45"
"2020-04-27","GABOTO","0","3","0","3"
"2020-04-27","GALVEZ","9","16","0","25"
"2020-04-27","GENERAL LAGOS","0","3","0","3"
"2020-04-27","GESSLER","0","0","1","1"
"2020-04-27","GOBERNADOR CRESPO","0","1","0","1"
"2020-04-27","GODOY","0","1","0","1"
"2020-04-27","GRANADERO BAIGORRIA","2","51","8","61"
"2020-04-27","GREGORIA PEREZ DE DENIS","0","0","1","1"
"2020-04-27","HELVECIA","2","15","1","18"
"2020-04-27","HUGHES","0","3","0","3"
"2020-04-27","HUMBERTO PRIMO","0","1","0","1"
"2020-04-27","HUMBOLDT","1","1","0","2"
"2020-04-27","IBARLUCEA","0","6","0","6"
"2020-04-27","JOSEFINA","0","2","0","2"
"2020-04-27","JUAN B. MOLINA","0","1","0","1"
"2020-04-27","JUNCAL","0","1","0","1"
"2020-04-27","LA BRAVA","0","1","0","1"
"2020-04-27","LA CRIOLLA","0","1","0","1"
"2020-04-27","LAGUNA PAIVA","0","5","0","5"
"2020-04-27","LANTERI","0","1","0","1"
"2020-04-27","LAS PAREJAS","1","7","0","8"
"2020-04-27","LAS ROSAS","1","6","0","7"
"2020-04-27","LAS TOSCAS","0","3","0","3"
"2020-04-27","LA VANGUARDIA","0","1","0","1"
"2020-04-27","LEHMANN","0","1","0","1"
"2020-04-27","LLAMBI CAMPBELL","3","1","1","5"
"2020-04-27","LOPEZ","0","2","0","2"
"2020-04-27","LOS MOLINOS","0","1","0","1"
"2020-04-27","LOS QUIRQUINCHOS","0","2","0","2"
"2020-04-27","LUIS PALACIOS","0","2","0","2"
"2020-04-27","MACIEL","0","3","0","3"
"2020-04-27","MALABRIGO","0","1","0","1"
"2020-04-27","MARGARITA","0","3","0","3"
"2020-04-27","MARIA JUANA","0","2","0","2"
"2020-04-27","MARIA SUSANA","0","3","0","3"
"2020-04-27","MARIA TERESA","0","2","0","2"
"2020-04-27","MAXIMO PAZ","0","1","0","1"
"2020-04-27","MELINCUE","0","1","0","1"
"2020-04-27","MONJE","0","2","0","2"
"2020-04-27","MONTEFIORE","0","1","0","1"
"2020-04-27","MONTES DE OCA","0","2","0","2"
"2020-04-27","MONTE VERA","0","7","0","7"
"2020-04-27","MURPHY","0","3","0","3"
"2020-04-27","NELSON","0","3","0","3"
"2020-04-27","NUEVO TORINO","0","1","0","1"
"2020-04-27","OLIVEROS","4","9","0","13"
"2020-04-27","PAVON","0","1","0","1"
"2020-04-27","PAVON ARRIBA","0","1","0","1"
"2020-04-27","PEREZ","0","39","2","41"
"2020-04-27","PIAMONTE","0","1","0","1"
"2020-04-27","PILAR","0","1","0","1"
"2020-04-27","PIÑERO","0","1","0","1"
"2020-04-27","PRESIDENTE ROCA","0","1","0","1"
"2020-04-27","PUEBLO ANDINO","2","2","0","4"
"2020-04-27","PUEBLO ESTHER","0","12","1","13"
"2020-04-27","PUEBLO IRIGOYEN","0","1","0","1"
"2020-04-27","PUERTO GENERAL SAN MARTIN","0","16","0","16"
"2020-04-27","PUERTO RECONQUISTA","0","1","0","1"
"2020-04-27","PUJATO","2","5","0","7"
"2020-04-27","RAFAELA","21","86","8","115"
"2020-04-27","RAMONA","0","2","0","2"
"2020-04-27","RECONQUISTA","0","33","2","35"
"2020-04-27","RECREO","0","13","2","15"
"2020-04-27","RICARDONE","0","4","0","4"
"2020-04-27","RINCON POTRERO","0","1","0","1"
"2020-04-27","ROLDAN","6","24","1","31"
"2020-04-27","ROMANG","0","1","0","1"
"2020-04-27","ROSARIO","98","2003","104","2205"
"2020-04-27","RUFINO","0","11","0","11"
"2020-04-27","SALTO GRANDE","0","2","0","2"
"2020-04-27","SAN ANTONIO DE OBLIGADO","0","1","0","1"
"2020-04-27","SAN CARLOS CENTRO","0","9","0","9"
"2020-04-27","SAN CARLOS SUD","1","0","0","1"
"2020-04-27","SAN CRISTOBAL","0","2","0","2"
"2020-04-27","SANCTI SPIRITU","1","19","0","20"
"2020-04-27","SAN EDUARDO","0","5","0","5"
"2020-04-27","SANFORD","0","1","0","1"
"2020-04-27","SAN FRANCISCO DE SANTA FE","0","1","0","1"
"2020-04-27","SAN GENARO","1","3","0","4"
"2020-04-27","SAN GREGORIO","0","1","0","1"
"2020-04-27","SAN GUILLERMO","0","3","0","3"
"2020-04-27","SAN JAVIER","1","6","1","8"
"2020-04-27","SAN JERONIMO DEL SAUCE","0","1","0","1"
"2020-04-27","SAN JERONIMO NORTE","0","2","0","2"
"2020-04-27","SAN JERONIMO SUD","0","3","0","3"
"2020-04-27","SAN JORGE","0","8","0","8"
"2020-04-27","SAN JOSE DE LA ESQUINA","0","5","0","5"
"2020-04-27","SAN JOSE DEL RINCON","1","9","3","13"
"2020-04-27","SAN JUSTO","0","7","1","8"
"2020-04-27","SAN LORENZO","3","49","6","58"
"2020-04-27","SANTA CLARA DE BUENA VISTA","0","2","0","2"
"2020-04-27","SANTA FE","27","506","31","564"
"2020-04-27","SANTA ISABEL","0","5","1","6"
"2020-04-27","SANTA ROSA DE CALCHINES","0","3","0","3"
"2020-04-27","SANTO DOMINGO","0","1","0","1"
"2020-04-27","SANTO TOME","5","71","3","79"
"2020-04-27","SAN VICENTE","0","2","0","2"
"2020-04-27","SARGENTO CABRAL","0","1","0","1"
"2020-04-27","SARMIENTO","0","2","0","2"
"2020-04-27","SASTRE","0","2","0","2"
"2020-04-27","SAUCE VIEJO","1","16","0","17"
"2020-04-27","SERODINO","0","2","0","2"
"2020-04-27","SOLDINI","0","1","0","1"
"2020-04-27","SUARDI","0","2","0","2"
"2020-04-27","SUNCHALES","0","4","0","4"
"2020-04-27","SUSANA","0","1","0","1"
"2020-04-27","TACURAL","0","2","0","2"
"2020-04-27","TEODELINA","0","7","0","7"
"2020-04-27","TIMBUES","0","3","1","4"
"2020-04-27","TOSTADO","0","4","0","4"
"2020-04-27","TOTORAS","0","3","0","3"
"2020-04-27","VENADO TUERTO","12","101","5","118"
"2020-04-27","VERA","1","16","0","17"
"2020-04-27","VIDELA","0","1","0","1"
"2020-04-27","VILLA ANA","0","1","0","1"
"2020-04-27","VILLA CAÑAS","0","2","0","2"
"2020-04-27","VILLA CONSTITUCION","9","27","4","40"
"2020-04-27","VILLA GOBERNADOR GALVEZ","2","99","11","112"
"2020-04-27","VILLA MINETTI","0","3","0","3"
"2020-04-27","VILLA MUGUETA","0","3","0","3"
"2020-04-27","VILLA OCAMPO","0","1","0","1"
"2020-04-27","WHEELWRIGHT","0","4","0","4"
"2020-04-27","ZAVALLA","0","1","0","1"
"2020-04-28","ACEBAL","0","2","1","3"
"2020-04-28","ALBARELLOS","0","1","0","1"
"2020-04-28","ALCORTA","0","3","0","3"
"2020-04-28","ALVAREZ","0","4","0","4"
"2020-04-28","ALVEAR","0","5","0","5"
"2020-04-28","ANGEL GALLARDO","0","4","0","4"
"2020-04-28","ARMSTRONG","2","11","0","13"
"2020-04-28","AROCENA","0","4","0","4"
"2020-04-28","ARROYO AGUIAR","0","1","0","1"
"2020-04-28","ARROYO LEYES","0","8","0","8"
"2020-04-28","ARROYO SECO","2","24","0","26"
"2020-04-28","ARRUFO","0","2","0","2"
"2020-04-28","ARTEAGA","0","2","0","2"
"2020-04-28","AVELLANEDA","0","11","1","12"
"2020-04-28","BARRANCAS","0","3","0","3"
"2020-04-28","BERAVEBU","0","1","0","1"
"2020-04-28","BERNARDO DE IRIGOYEN","0","1","0","1"
"2020-04-28","BIGAND","0","11","0","11"
"2020-04-28","BOMBAL","0","3","0","3"
"2020-04-28","BOUQUET","0","1","0","1"
"2020-04-28","CAFFERATA","0","2","0","2"
"2020-04-28","CALCHAQUI","0","3","0","3"
"2020-04-28","CAÑADA DE GOMEZ","1","22","1","24"
"2020-04-28","CAÑADA DEL UCLE","0","1","0","1"
"2020-04-28","CAPITAN BERMUDEZ","1","30","2","33"
"2020-04-28","CARCARAÑA","0","10","0","10"
"2020-04-28","CARLOS PELLEGRINI","0","2","0","2"
"2020-04-28","CARMEN","0","1","0","1"
"2020-04-28","CARRERAS","0","3","0","3"
"2020-04-28","CARRIZALES","0","1","0","1"
"2020-04-28","CASILDA","2","34","1","37"
"2020-04-28","CAYASTA","1","4","0","5"
"2020-04-28","CERES","0","15","1","16"
"2020-04-28","CHABAS","1","2","0","3"
"2020-04-28","CHAÑAR LADEADO","0","1","0","1"
"2020-04-28","CHOVET","0","1","0","1"
"2020-04-28","CLASON","0","1","0","1"
"2020-04-28","COLONIA MASCIAS","0","0","1","1"
"2020-04-28","COLONIA ROSA","0","1","0","1"
"2020-04-28","CORONDA","0","10","0","10"
"2020-04-28","CORONEL ARNOLD","0","1","0","1"
"2020-04-28","CORONEL RODOLFO S. DOMINGUEZ","0","2","0","2"
"2020-04-28","CORREA","0","5","0","5"
"2020-04-28","DESVIO ARIJON","0","1","0","1"
"2020-04-28","DIAZ","0","1","0","1"
"2020-04-28","DIEGO DE ALVEAR","0","1","0","1"
"2020-04-28","ELORTONDO","4","6","0","10"
"2020-04-28","EL RABON","0","1","0","1"
"2020-04-28","EL TREBOL","0","3","0","3"
"2020-04-28","EMPALME VILLA CONSTITUCION","0","2","1","3"
"2020-04-28","ESPERANZA","1","25","0","26"
"2020-04-28","FIGHIERA","0","3","0","3"
"2020-04-28","FIRMAT","1","14","0","15"
"2020-04-28","FLORENCIA","0","3","0","3"
"2020-04-28","FRANCK","1","7","0","8"
"2020-04-28","FRAY LUIS BELTRAN","4","20","1","25"
"2020-04-28","FRONTERA","0","7","1","8"
"2020-04-28","FUENTES","0","2","0","2"
"2020-04-28","FUNES","5","40","2","47"
"2020-04-28","GABOTO","0","3","0","3"
"2020-04-28","GALVEZ","9","16","1","26"
"2020-04-28","GENERAL LAGOS","0","3","0","3"
"2020-04-28","GESSLER","0","0","1","1"
"2020-04-28","GOBERNADOR CRESPO","0","1","0","1"
"2020-04-28","GODOY","0","1","0","1"
"2020-04-28","GRANADERO BAIGORRIA","2","59","1","62"
"2020-04-28","GREGORIA PEREZ DE DENIS","0","0","1","1"
"2020-04-28","HELVECIA","2","15","1","18"
"2020-04-28","HUGHES","0","3","0","3"
"2020-04-28","HUMBERTO PRIMO","0","1","0","1"
"2020-04-28","HUMBOLDT","1","1","0","2"
"2020-04-28","IBARLUCEA","0","6","0","6"
"2020-04-28","JOSEFINA","0","2","0","2"
"2020-04-28","JUAN B. MOLINA","0","1","0","1"
"2020-04-28","JUNCAL","0","2","0","2"
"2020-04-28","LA BRAVA","0","1","0","1"
"2020-04-28","LA CRIOLLA","0","1","1","2"
"2020-04-28","LAGUNA PAIVA","0","5","0","5"
"2020-04-28","LANTERI","0","1","0","1"
"2020-04-28","LAS PAREJAS","1","7","0","8"
"2020-04-28","LAS ROSAS","1","6","1","8"
"2020-04-28","LAS TOSCAS","0","3","0","3"
"2020-04-28","LA VANGUARDIA","0","1","0","1"
"2020-04-28","LEHMANN","0","1","0","1"
"2020-04-28","LLAMBI CAMPBELL","3","2","1","6"
"2020-04-28","LOPEZ","0","2","0","2"
"2020-04-28","LOS MOLINOS","0","1","0","1"
"2020-04-28","LOS QUIRQUINCHOS","0","3","0","3"
"2020-04-28","LUIS PALACIOS","0","2","0","2"
"2020-04-28","MACIEL","0","3","0","3"
"2020-04-28","MAGGIOLO","0","2","0","2"
"2020-04-28","MALABRIGO","0","1","0","1"
"2020-04-28","MARGARITA","0","3","0","3"
"2020-04-28","MARIA JUANA","0","2","0","2"
"2020-04-28","MARIA SUSANA","0","3","0","3"
"2020-04-28","MARIA TERESA","0","2","0","2"
"2020-04-28","MAXIMO PAZ","0","1","0","1"
"2020-04-28","MELINCUE","0","1","0","1"
"2020-04-28","MONJE","0","2","0","2"
"2020-04-28","MONTEFIORE","0","1","0","1"
"2020-04-28","MONTES DE OCA","0","2","0","2"
"2020-04-28","MONTE VERA","0","7","0","7"
"2020-04-28","MURPHY","0","3","0","3"
"2020-04-28","NELSON","0","3","0","3"
"2020-04-28","NUEVO TORINO","0","1","0","1"
"2020-04-28","OLIVEROS","4","9","0","13"
"2020-04-28","PAVON","0","1","0","1"
"2020-04-28","PAVON ARRIBA","0","1","0","1"
"2020-04-28","PEREZ","0","39","2","41"
"2020-04-28","PIAMONTE","0","1","0","1"
"2020-04-28","PILAR","0","1","0","1"
"2020-04-28","PIÑERO","0","1","0","1"
"2020-04-28","PRESIDENTE ROCA","0","1","0","1"
"2020-04-28","PUEBLO ANDINO","2","2","0","4"
"2020-04-28","PUEBLO ESTHER","0","14","0","14"
"2020-04-28","PUEBLO IRIGOYEN","0","1","0","1"
"2020-04-28","PUERTO GENERAL SAN MARTIN","0","16","1","17"
"2020-04-28","PUERTO RECONQUISTA","0","1","0","1"
"2020-04-28","PUJATO","2","5","0","7"
"2020-04-28","RAFAELA","21","89","7","117"
"2020-04-28","RAMONA","0","2","0","2"
"2020-04-28","RECONQUISTA","0","33","2","35"
"2020-04-28","RECREO","0","15","0","15"
"2020-04-28","RICARDONE","0","5","0","5"
"2020-04-28","RINCON POTRERO","0","1","0","1"
"2020-04-28","ROLDAN","6","26","2","34"
"2020-04-28","ROMANG","0","1","0","1"
"2020-04-28","ROSARIO","98","2131","68","2297"
"2020-04-28","RUFINO","0","11","0","11"
"2020-04-28","SALTO GRANDE","0","2","0","2"
"2020-04-28","SAN ANTONIO DE OBLIGADO","0","1","0","1"
"2020-04-28","SAN CARLOS CENTRO","0","9","0","9"
"2020-04-28","SAN CARLOS SUD","1","0","0","1"
"2020-04-28","SAN CRISTOBAL","0","2","0","2"
"2020-04-28","SANCTI SPIRITU","1","20","0","21"
"2020-04-28","SAN EDUARDO","0","5","0","5"
"2020-04-28","SANFORD","0","1","0","1"
"2020-04-28","SAN FRANCISCO DE SANTA FE","0","1","0","1"
"2020-04-28","SAN GENARO","1","3","0","4"
"2020-04-28","SAN GREGORIO","0","1","0","1"
"2020-04-28","SAN GUILLERMO","0","3","0","3"
"2020-04-28","SAN JAVIER","1","7","0","8"
"2020-04-28","SAN JERONIMO DEL SAUCE","0","1","0","1"
"2020-04-28","SAN JERONIMO NORTE","0","2","0","2"
"2020-04-28","SAN JERONIMO SUD","0","4","0","4"
"2020-04-28","SAN JORGE","0","8","0","8"
"2020-04-28","SAN JOSE DE LA ESQUINA","0","5","0","5"
"2020-04-28","SAN JOSE DEL RINCON","1","11","1","13"
"2020-04-28","SAN JUSTO","0","8","0","8"
"2020-04-28","SAN LORENZO","3","52","9","64"
"2020-04-28","SANTA CLARA DE BUENA VISTA","0","2","0","2"
"2020-04-28","SANTA FE","27","517","27","571"
"2020-04-28","SANTA ISABEL","0","6","1","7"
"2020-04-28","SANTA ROSA DE CALCHINES","0","3","0","3"
"2020-04-28","SANTO DOMINGO","0","1","0","1"
"2020-04-28","SANTO TOME","5","74","3","82"
"2020-04-28","SAN VICENTE","0","2","0","2"
"2020-04-28","SARGENTO CABRAL","0","1","0","1"
"2020-04-28","SARMIENTO","0","2","0","2"
"2020-04-28","SASTRE","0","2","0","2"
"2020-04-28","SAUCE VIEJO","1","16","0","17"
"2020-04-28","SERODINO","0","2","0","2"
"2020-04-28","SOLDINI","0","1","0","1"
"2020-04-28","SUARDI","0","2","0","2"
"2020-04-28","SUNCHALES","0","4","0","4"
"2020-04-28","SUSANA","0","1","0","1"
"2020-04-28","TACURAL","0","2","0","2"
"2020-04-28","TEODELINA","0","7","0","7"
"2020-04-28","TIMBUES","0","3","1","4"
"2020-04-28","TOSTADO","0","4","1","5"
"2020-04-28","TOTORAS","0","3","0","3"
"2020-04-28","VENADO TUERTO","12","118","7","137"
"2020-04-28","VERA","1","16","0","17"
"2020-04-28","VIDELA","0","1","0","1"
"2020-04-28","VILLA ANA","0","1","0","1"
"2020-04-28","VILLA CAÑAS","0","2","0","2"
"2020-04-28","VILLA CONSTITUCION","9","31","1","41"
"2020-04-28","VILLA GOBERNADOR GALVEZ","2","108","5","115"
"2020-04-28","VILLA MINETTI","0","3","0","3"
"2020-04-28","VILLA MUGUETA","0","3","0","3"
"2020-04-28","VILLA OCAMPO","0","1","0","1"
"2020-04-28","WHEELWRIGHT","0","5","1","6"
"2020-04-28","ZAVALLA","0","1","0","1"
"2020-04-29","ACEBAL","0","3","0","3"
"2020-04-29","ALBARELLOS","0","1","0","1"
"2020-04-29","ALCORTA","0","3","0","3"
"2020-04-29","ALVAREZ","0","4","0","4"
"2020-04-29","ALVEAR","0","5","0","5"
"2020-04-29","ANGEL GALLARDO","0","4","0","4"
"2020-04-29","ARMSTRONG","2","12","0","14"
"2020-04-29","AROCENA","0","4","1","5"
"2020-04-29","ARROYO AGUIAR","0","1","0","1"
"2020-04-29","ARROYO LEYES","0","8","0","8"
"2020-04-29","ARROYO SECO","2","27","0","29"
"2020-04-29","ARRUFO","0","2","0","2"
"2020-04-29","ARTEAGA","0","2","0","2"
"2020-04-29","AVELLANEDA","0","11","1","12"
"2020-04-29","BARRANCAS","0","3","0","3"
"2020-04-29","BERAVEBU","0","1","0","1"
"2020-04-29","BERNARDO DE IRIGOYEN","0","1","0","1"
"2020-04-29","BIGAND","0","11","0","11"
"2020-04-29","BOMBAL","0","3","0","3"
"2020-04-29","BOUQUET","0","1","0","1"
"2020-04-29","CAFFERATA","0","2","0","2"
"2020-04-29","CALCHAQUI","0","3","0","3"
"2020-04-29","CAÑADA DE GOMEZ","1","24","1","26"
"2020-04-29","CAÑADA DEL UCLE","0","1","0","1"
"2020-04-29","CAPITAN BERMUDEZ","1","35","1","37"
"2020-04-29","CARCARAÑA","0","10","0","10"
"2020-04-29","CARLOS PELLEGRINI","0","2","0","2"
"2020-04-29","CARMEN","0","1","0","1"
"2020-04-29","CARRERAS","0","3","0","3"
"2020-04-29","CARRIZALES","0","1","0","1"
"2020-04-29","CASILDA","2","35","1","38"
"2020-04-29","CAYASTA","1","4","0","5"
"2020-04-29","CERES","0","16","0","16"
"2020-04-29","CHABAS","1","3","0","4"
"2020-04-29","CHAÑAR LADEADO","0","1","0","1"
"2020-04-29","CHOVET","0","1","0","1"
"2020-04-29","CLASON","0","1","0","1"
"2020-04-29","COLONIA MASCIAS","0","1","0","1"
"2020-04-29","COLONIA ROSA","0","1","0","1"
"2020-04-29","CORONDA","0","10","0","10"
"2020-04-29","CORONEL ARNOLD","0","1","0","1"
"2020-04-29","CORONEL RODOLFO S. DOMINGUEZ","0","2","0","2"
"2020-04-29","CORREA","0","5","0","5"
"2020-04-29","DESVIO ARIJON","0","1","0","1"
"2020-04-29","DIAZ","0","1","0","1"
"2020-04-29","DIEGO DE ALVEAR","0","1","0","1"
"2020-04-29","ELORTONDO","4","6","0","10"
"2020-04-29","EL RABON","0","1","0","1"
"2020-04-29","EL TREBOL","0","3","0","3"
"2020-04-29","EMPALME VILLA CONSTITUCION","0","3","0","3"
"2020-04-29","ESPERANZA","1","25","1","27"
"2020-04-29","FIGHIERA","0","3","0","3"
"2020-04-29","FIRMAT","1","14","0","15"
"2020-04-29","FLORENCIA","0","3","0","3"
"2020-04-29","FRANCK","1","7","0","8"
"2020-04-29","FRAY LUIS BELTRAN","4","23","0","27"
"2020-04-29","FRONTERA","0","8","1","9"
"2020-04-29","FUENTES","0","2","0","2"
"2020-04-29","FUNES","5","41","2","48"
"2020-04-29","GABOTO","0","3","0","3"
"2020-04-29","GALVEZ","9","17","0","26"
"2020-04-29","GENERAL LAGOS","0","4","0","4"
"2020-04-29","GESSLER","0","0","1","1"
"2020-04-29","GOBERNADOR CRESPO","0","1","0","1"
"2020-04-29","GODOY","0","1","0","1"
"2020-04-29","GRANADERO BAIGORRIA","2","60","3","65"
"2020-04-29","GREGORIA PEREZ DE DENIS","0","1","0","1"
"2020-04-29","HELVECIA","2","15","1","18"
"2020-04-29","HUGHES","0","5","0","5"
"2020-04-29","HUMBERTO PRIMO","0","1","0","1"
"2020-04-29","HUMBOLDT","1","1","0","2"
"2020-04-29","IBARLUCEA","0","6","0","6"
"2020-04-29","JOSEFINA","0","2","0","2"
"2020-04-29","JUAN B. MOLINA","0","1","0","1"
"2020-04-29","JUNCAL","0","2","0","2"
"2020-04-29","LA BRAVA","0","1","0","1"
"2020-04-29","LA CRIOLLA","0","2","0","2"
"2020-04-29","LAGUNA PAIVA","0","5","0","5"
"2020-04-29","LANTERI","0","1","0","1"
"2020-04-29","LAS PAREJAS","1","7","0","8"
"2020-04-29","LAS ROSAS","1","7","0","8"
"2020-04-29","LAS TOSCAS","0","3","0","3"
"2020-04-29","LA VANGUARDIA","0","1","0","1"
"2020-04-29","LEHMANN","0","2","0","2"
"2020-04-29","LLAMBI CAMPBELL","3","3","0","6"
"2020-04-29","LOPEZ","0","2","0","2"
"2020-04-29","LOS MOLINOS","0","1","0","1"
"2020-04-29","LOS QUIRQUINCHOS","0","3","0","3"
"2020-04-29","LUIS PALACIOS","0","2","0","2"
"2020-04-29","MACIEL","0","3","0","3"
"2020-04-29","MAGGIOLO","0","2","0","2"
"2020-04-29","MALABRIGO","0","1","0","1"
"2020-04-29","MARGARITA","0","3","0","3"
"2020-04-29","MARIA JUANA","0","2","0","2"
"2020-04-29","MARIA SUSANA","0","3","0","3"
"2020-04-29","MARIA TERESA","0","2","0","2"
"2020-04-29","MAXIMO PAZ","0","1","0","1"
"2020-04-29","MELINCUE","0","1","0","1"
"2020-04-29","MONJE","0","2","0","2"
"2020-04-29","MONTEFIORE","0","1","0","1"
"2020-04-29","MONTES DE OCA","0","2","0","2"
"2020-04-29","MONTE VERA","0","7","0","7"
"2020-04-29","MURPHY","0","3","0","3"
"2020-04-29","NELSON","0","3","0","3"
"2020-04-29","NUEVO TORINO","0","1","0","1"
"2020-04-29","OLIVEROS","4","9","1","14"
"2020-04-29","PAVON","0","1","1","2"
"2020-04-29","PAVON ARRIBA","0","1","0","1"
"2020-04-29","PEREZ","0","42","2","44"
"2020-04-29","PIAMONTE","0","1","0","1"
"2020-04-29","PILAR","0","1","0","1"
"2020-04-29","PIÑERO","0","1","0","1"
"2020-04-29","PRESIDENTE ROCA","0","1","0","1"
"2020-04-29","PUEBLO ANDINO","2","2","0","4"
"2020-04-29","PUEBLO ESTHER","0","14","1","15"
"2020-04-29","PUEBLO IRIGOYEN","0","1","0","1"
"2020-04-29","PUEBLO URANGA","0","1","0","1"
"2020-04-29","PUERTO GENERAL SAN MARTIN","0","17","0","17"
"2020-04-29","PUERTO RECONQUISTA","0","1","0","1"
"2020-04-29","PUJATO","2","5","0","7"
"2020-04-29","RAFAELA","21","90","7","118"
"2020-04-29","RAMONA","0","2","0","2"
"2020-04-29","RECONQUISTA","0","34","1","35"
"2020-04-29","RECREO","0","15","1","16"
"2020-04-29","RICARDONE","0","7","0","7"
"2020-04-29","RINCON POTRERO","0","1","0","1"
"2020-04-29","ROLDAN","6","27","1","34"
"2020-04-29","ROMANG","0","1","0","1"
"2020-04-29","ROSARIO","98","2217","54","2369"
"2020-04-29","RUFINO","0","12","0","12"
"2020-04-29","SALTO GRANDE","0","2","0","2"
"2020-04-29","SAN ANTONIO DE OBLIGADO","0","1","0","1"
"2020-04-29","SAN CARLOS CENTRO","0","9","0","9"
"2020-04-29","SAN CARLOS SUD","1","0","0","1"
"2020-04-29","SAN CRISTOBAL","0","2","0","2"
"2020-04-29","SANCTI SPIRITU","1","21","0","22"
"2020-04-29","SAN EDUARDO","0","5","0","5"
"2020-04-29","SANFORD","0","1","0","1"
"2020-04-29","SAN FRANCISCO DE SANTA FE","0","1","0","1"
"2020-04-29","SAN GENARO","1","4","0","5"
"2020-04-29","SAN GREGORIO","0","1","0","1"
"2020-04-29","SAN GUILLERMO","0","3","0","3"
"2020-04-29","SAN JAVIER","1","7","0","8"
"2020-04-29","SAN JERONIMO DEL SAUCE","0","1","0","1"
"2020-04-29","SAN JERONIMO NORTE","0","2","0","2"
"2020-04-29","SAN JERONIMO SUD","0","4","0","4"
"2020-04-29","SAN JORGE","0","8","0","8"
"2020-04-29","SAN JOSE DE LA ESQUINA","0","5","0","5"
"2020-04-29","SAN JOSE DEL RINCON","1","11","2","14"
"2020-04-29","SAN JUSTO","0","8","2","10"
"2020-04-29","SAN LORENZO","3","57","6","66"
"2020-04-29","SANTA CLARA DE BUENA VISTA","0","2","0","2"
"2020-04-29","SANTA FE","27","520","32","579"
"2020-04-29","SANTA ISABEL","0","6","1","7"
"2020-04-29","SANTA ROSA DE CALCHINES","0","3","0","3"
"2020-04-29","SANTO DOMINGO","0","1","0","1"
"2020-04-29","SANTO TOME","5","74","5","84"
"2020-04-29","SAN VICENTE","0","2","0","2"
"2020-04-29","SARGENTO CABRAL","0","1","0","1"
"2020-04-29","SARMIENTO","0","2","0","2"
"2020-04-29","SASTRE","0","2","1","3"
"2020-04-29","SAUCE VIEJO","1","16","1","18"
"2020-04-29","SERODINO","0","2","0","2"
"2020-04-29","SOLDINI","0","2","0","2"
"2020-04-29","SUARDI","0","2","1","3"
"2020-04-29","SUNCHALES","0","4","0","4"
"2020-04-29","SUSANA","0","1","0","1"
"2020-04-29","TACURAL","0","2","0","2"
"2020-04-29","TEODELINA","0","7","0","7"
"2020-04-29","TIMBUES","0","3","1","4"
"2020-04-29","TOSTADO","0","5","0","5"
"2020-04-29","TOTORAS","0","3","0","3"
"2020-04-29","VENADO TUERTO","12","123","10","145"
"2020-04-29","VERA","1","16","0","17"
"2020-04-29","VIDELA","0","1","0","1"
"2020-04-29","VILLA ANA","0","1","0","1"
"2020-04-29","VILLA CAÑAS","0","2","0","2"
"2020-04-29","VILLA CONSTITUCION","9","32","1","42"
"2020-04-29","VILLADA","0","1","0","1"
"2020-04-29","VILLA GOBERNADOR GALVEZ","2","114","8","124"
"2020-04-29","VILLA MINETTI","0","3","0","3"
"2020-04-29","VILLA MUGUETA","0","4","0","4"
"2020-04-29","VILLA OCAMPO","0","1","0","1"
"2020-04-29","WHEELWRIGHT","0","5","1","6"
"2020-04-29","ZAVALLA","0","1","0","1"
"2020-04-30","ACEBAL","0","3","0","3"
"2020-04-30","ALBARELLOS","0","1","0","1"
"2020-04-30","ALCORTA","0","3","0","3"
"2020-04-30","ALVAREZ","0","4","0","4"
"2020-04-30","ALVEAR","0","5","0","5"
"2020-04-30","ANGEL GALLARDO","0","4","0","4"
"2020-04-30","ARMSTRONG","2","12","0","14"
"2020-04-30","AROCENA","0","5","0","5"
"2020-04-30","ARROYO AGUIAR","0","1","0","1"
"2020-04-30","ARROYO LEYES","0","8","0","8"
"2020-04-30","ARROYO SECO","2","27","0","29"
"2020-04-30","ARRUFO","0","2","0","2"
"2020-04-30","ARTEAGA","0","2","0","2"
"2020-04-30","AVELLANEDA","0","12","0","12"
"2020-04-30","BARRANCAS","0","3","0","3"
"2020-04-30","BERAVEBU","0","1","0","1"
"2020-04-30","BERNARDO DE IRIGOYEN","0","1","0","1"
"2020-04-30","BIGAND","0","11","0","11"
"2020-04-30","BOMBAL","0","3","0","3"
"2020-04-30","BOUQUET","0","1","0","1"
"2020-04-30","CAFFERATA","0","2","0","2"
"2020-04-30","CALCHAQUI","0","3","0","3"
"2020-04-30","CAÑADA DE GOMEZ","1","25","0","26"
"2020-04-30","CAÑADA DEL UCLE","0","1","0","1"
"2020-04-30","CAPITAN BERMUDEZ","1","37","1","39"
"2020-04-30","CARCARAÑA","0","10","0","10"
"2020-04-30","CARLOS PELLEGRINI","0","3","0","3"
"2020-04-30","CARMEN","0","1","0","1"
"2020-04-30","CARRERAS","0","3","0","3"
"2020-04-30","CARRIZALES","0","1","0","1"
"2020-04-30","CASILDA","2","35","1","38"
"2020-04-30","CAYASTA","1","4","0","5"
"2020-04-30","CERES","0","16","0","16"
"2020-04-30","CHABAS","1","3","0","4"
"2020-04-30","CHAÑAR LADEADO","0","1","0","1"
"2020-04-30","CHOVET","0","1","2","3"
"2020-04-30","CLASON","0","1","0","1"
"2020-04-30","COLONIA MASCIAS","0","1","0","1"
"2020-04-30","COLONIA ROSA","0","1","0","1"
"2020-04-30","CORONDA","0","10","0","10"
"2020-04-30","CORONEL ARNOLD","0","1","0","1"
"2020-04-30","CORONEL RODOLFO S. DOMINGUEZ","0","2","0","2"
"2020-04-30","CORREA","0","5","0","5"
"2020-04-30","DESVIO ARIJON","0","1","0","1"
"2020-04-30","DIAZ","0","1","0","1"
"2020-04-30","DIEGO DE ALVEAR","0","1","0","1"
"2020-04-30","ELORTONDO","4","6","1","11"
"2020-04-30","EL RABON","0","1","0","1"
"2020-04-30","EL TREBOL","0","3","0","3"
"2020-04-30","EMPALME VILLA CONSTITUCION","0","3","0","3"
"2020-04-30","ESPERANZA","1","25","2","28"
"2020-04-30","FIGHIERA","0","3","0","3"
"2020-04-30","FIRMAT","1","14","0","15"
"2020-04-30","FLORENCIA","0","3","0","3"
"2020-04-30","FRANCK","1","7","0","8"
"2020-04-30","FRAY LUIS BELTRAN","4","24","0","28"
"2020-04-30","FRONTERA","0","8","1","9"
"2020-04-30","FUENTES","0","2","0","2"
"2020-04-30","FUNES","5","43","1","49"
"2020-04-30","GABOTO","0","3","0","3"
"2020-04-30","GALVEZ","9","18","0","27"
"2020-04-30","GENERAL LAGOS","0","4","0","4"
"2020-04-30","GESSLER","0","0","1","1"
"2020-04-30","GOBERNADOR CRESPO","0","1","1","2"
"2020-04-30","GODOY","0","1","0","1"
"2020-04-30","GRANADERO BAIGORRIA","2","62","5","69"
"2020-04-30","GREGORIA PEREZ DE DENIS","0","1","0","1"
"2020-04-30","HELVECIA","2","15","1","18"
"2020-04-30","HUGHES","0","5","0","5"
"2020-04-30","HUMBERTO PRIMO","0","1","0","1"
"2020-04-30","HUMBOLDT","1","1","0","2"
"2020-04-30","IBARLUCEA","0","6","0","6"
"2020-04-30","JOSEFINA","0","2","0","2"
"2020-04-30","JUAN B. MOLINA","0","1","0","1"
"2020-04-30","JUNCAL","0","2","0","2"
"2020-04-30","LA BRAVA","0","1","0","1"
"2020-04-30","LA CRIOLLA","0","2","0","2"
"2020-04-30","LAGUNA PAIVA","0","5","0","5"
"2020-04-30","LANDETA","0","0","1","1"
"2020-04-30","LANTERI","0","1","0","1"
"2020-04-30","LAS PAREJAS","1","7","1","9"
"2020-04-30","LAS ROSAS","1","7","0","8"
"2020-04-30","LAS TOSCAS","0","3","0","3"
"2020-04-30","LA VANGUARDIA","0","1","0","1"
"2020-04-30","LEHMANN","0","2","0","2"
"2020-04-30","LLAMBI CAMPBELL","3","3","0","6"
"2020-04-30","LOPEZ","0","2","0","2"
"2020-04-30","LOS MOLINOS","0","1","0","1"
"2020-04-30","LOS QUIRQUINCHOS","0","3","0","3"
"2020-04-30","LUIS PALACIOS","0","2","0","2"
"2020-04-30","MACIEL","0","3","1","4"
"2020-04-30","MAGGIOLO","0","2","0","2"
"2020-04-30","MALABRIGO","0","1","0","1"
"2020-04-30","MARGARITA","0","3","0","3"
"2020-04-30","MARIA JUANA","0","2","0","2"
"2020-04-30","MARIA SUSANA","0","3","0","3"
"2020-04-30","MARIA TERESA","0","2","0","2"
"2020-04-30","MAXIMO PAZ","0","1","0","1"
"2020-04-30","MELINCUE","0","1","0","1"
"2020-04-30","MIGUEL TORRES","0","2","0","2"
"2020-04-30","MONJE","0","2","0","2"
"2020-04-30","MONTEFIORE","0","1","0","1"
"2020-04-30","MONTES DE OCA","0","2","0","2"
"2020-04-30","MONTE VERA","0","7","0","7"
"2020-04-30","MURPHY","0","3","0","3"
"2020-04-30","NELSON","0","3","0","3"
"2020-04-30","NUEVO TORINO","0","1","0","1"
"2020-04-30","OLIVEROS","4","9","1","14"
"2020-04-30","PAVON","0","1","1","2"
"2020-04-30","PAVON ARRIBA","0","1","0","1"
"2020-04-30","PEREZ","0","43","1","44"
"2020-04-30","PIAMONTE","0","1","0","1"
"2020-04-30","PILAR","0","1","0","1"
"2020-04-30","PIÑERO","0","1","0","1"
"2020-04-30","PRESIDENTE ROCA","0","1","0","1"
"2020-04-30","PUEBLO ANDINO","2","2","0","4"
"2020-04-30","PUEBLO ESTHER","0","14","1","15"
"2020-04-30","PUEBLO IRIGOYEN","0","1","0","1"
"2020-04-30","PUEBLO URANGA","0","1","0","1"
"2020-04-30","PUERTO GENERAL SAN MARTIN","0","17","0","17"
"2020-04-30","PUERTO RECONQUISTA","0","1","0","1"
"2020-04-30","PUJATO","2","5","0","7"
"2020-04-30","RAFAELA","21","93","8","122"
"2020-04-30","RAMONA","0","2","0","2"
"2020-04-30","RECONQUISTA","0","34","1","35"
"2020-04-30","RECREO","0","16","0","16"
"2020-04-30","RICARDONE","0","8","0","8"
"2020-04-30","RINCON POTRERO","0","1","0","1"
"2020-04-30","ROLDAN","6","28","0","34"
"2020-04-30","ROMANG","0","1","0","1"
"2020-04-30","ROSARIO","98","2300","53","2451"
"2020-04-30","RUFINO","0","14","0","14"
"2020-04-30","SALTO GRANDE","0","2","0","2"
"2020-04-30","SAN ANTONIO DE OBLIGADO","0","1","0","1"
"2020-04-30","SAN CARLOS CENTRO","0","9","0","9"
"2020-04-30","SAN CARLOS SUD","1","0","0","1"
"2020-04-30","SAN CRISTOBAL","0","2","1","3"
"2020-04-30","SANCTI SPIRITU","1","21","3","25"
"2020-04-30","SAN EDUARDO","0","5","0","5"
"2020-04-30","SANFORD","0","1","0","1"
"2020-04-30","SAN FRANCISCO DE SANTA FE","0","1","0","1"
"2020-04-30","SAN GENARO","1","4","0","5"
"2020-04-30","SAN GREGORIO","0","1","0","1"
"2020-04-30","SAN GUILLERMO","0","3","0","3"
"2020-04-30","SAN JAVIER","1","7","0","8"
"2020-04-30","SAN JERONIMO DEL SAUCE","0","1","0","1"
"2020-04-30","SAN JERONIMO NORTE","0","2","0","2"
"2020-04-30","SAN JERONIMO SUD","0","4","0","4"
"2020-04-30","SAN JORGE","0","8","0","8"
"2020-04-30","SAN JOSE DE LA ESQUINA","0","5","1","6"
"2020-04-30","SAN JOSE DEL RINCON","1","11","2","14"
"2020-04-30","SAN JUSTO","0","10","1","11"
"2020-04-30","SAN LORENZO","3","65","6","74"
"2020-04-30","SANTA CLARA DE BUENA VISTA","0","2","0","2"
"2020-04-30","SANTA FE","27","533","32","592"
"2020-04-30","SANTA ISABEL","0","6","1","7"
"2020-04-30","SANTA ROSA DE CALCHINES","0","3","0","3"
"2020-04-30","SANTO DOMINGO","0","1","0","1"
"2020-04-30","SANTO TOME","5","79","1","85"
"2020-04-30","SAN VICENTE","0","2","0","2"
"2020-04-30","SARGENTO CABRAL","0","1","0","1"
"2020-04-30","SARMIENTO","0","2","0","2"
"2020-04-30","SASTRE","0","3","0","3"
"2020-04-30","SAUCE VIEJO","1","17","0","18"
"2020-04-30","SERODINO","0","2","0","2"
"2020-04-30","SOLDINI","0","2","0","2"
"2020-04-30","SUARDI","0","3","0","3"
"2020-04-30","SUNCHALES","0","4","0","4"
"2020-04-30","SUSANA","0","1","0","1"
"2020-04-30","TACURAL","0","2","0","2"
"2020-04-30","TEODELINA","0","7","0","7"
"2020-04-30","TIMBUES","0","3","1","4"
"2020-04-30","TOSTADO","0","4","0","4"
"2020-04-30","TOTORAS","0","3","0","3"
"2020-04-30","VENADO TUERTO","12","128","7","147"
"2020-04-30","VERA","1","16","0","17"
"2020-04-30","VIDELA","0","1","0","1"
"2020-04-30","VILLA ANA","0","1","0","1"
"2020-04-30","VILLA CAÑAS","0","3","1","4"
"2020-04-30","VILLA CONSTITUCION","9","32","1","42"
"2020-04-30","VILLADA","0","1","0","1"
"2020-04-30","VILLA GOBERNADOR GALVEZ","2","119","7","128"
"2020-04-30","VILLA MINETTI","0","3","0","3"
"2020-04-30","VILLA MUGUETA","0","4","0","4"
"2020-04-30","VILLA OCAMPO","0","1","0","1"
"2020-04-30","WHEELWRIGHT","0","5","1","6"
"2020-04-30","ZAVALLA","0","1","0","1"
"2020-05-01","ACEBAL","0","3","1","4"
"2020-05-01","ALBARELLOS","0","1","0","1"
"2020-05-01","ALCORTA","0","3","0","3"
"2020-05-01","ALVAREZ","0","4","0","4"
"2020-05-01","ALVEAR","0","5","1","6"
"2020-05-01","ANGEL GALLARDO","0","4","0","4"
"2020-05-01","ARMSTRONG","2","12","0","14"
"2020-05-01","AROCENA","0","5","0","5"
"2020-05-01","ARROYO AGUIAR","0","1","0","1"
"2020-05-01","ARROYO LEYES","0","8","0","8"
"2020-05-01","ARROYO SECO","2","27","0","29"
"2020-05-01","ARRUFO","0","2","0","2"
"2020-05-01","ARTEAGA","0","2","0","2"
"2020-05-01","AVELLANEDA","0","12","0","12"
"2020-05-01","BARRANCAS","0","3","0","3"
"2020-05-01","BERAVEBU","0","1","0","1"
"2020-05-01","BERNARDO DE IRIGOYEN","0","1","0","1"
"2020-05-01","BIGAND","0","11","0","11"
"2020-05-01","BOMBAL","0","3","1","4"
"2020-05-01","BOUQUET","0","1","0","1"
"2020-05-01","CAFFERATA","0","2","0","2"
"2020-05-01","CALCHAQUI","0","3","0","3"
"2020-05-01","CAÑADA DE GOMEZ","1","25","0","26"
"2020-05-01","CAÑADA DEL UCLE","0","1","0","1"
"2020-05-01","CAPITAN BERMUDEZ","1","39","1","41"
"2020-05-01","CARCARAÑA","0","10","0","10"
"2020-05-01","CARLOS PELLEGRINI","0","3","0","3"
"2020-05-01","CARMEN","0","1","0","1"
"2020-05-01","CARRERAS","0","3","0","3"
"2020-05-01","CARRIZALES","0","1","0","1"
"2020-05-01","CASILDA","2","35","2","39"
"2020-05-01","CAYASTA","1","4","0","5"
"2020-05-01","CERES","0","16","1","17"
"2020-05-01","CHABAS","1","3","0","4"
"2020-05-01","CHAÑAR LADEADO","0","1","0","1"
"2020-05-01","CHOVET","0","1","2","3"
"2020-05-01","CLASON","0","1","0","1"
"2020-05-01","COLONIA MASCIAS","0","1","0","1"
"2020-05-01","COLONIA ROSA","0","1","0","1"
"2020-05-01","CORONDA","0","10","0","10"
"2020-05-01","CORONEL ARNOLD","0","1","0","1"
"2020-05-01","CORONEL RODOLFO S. DOMINGUEZ","0","2","0","2"
"2020-05-01","CORREA","0","5","0","5"
"2020-05-01","DESVIO ARIJON","0","1","0","1"
"2020-05-01","DIAZ","0","1","0","1"
"2020-05-01","DIEGO DE ALVEAR","0","1","0","1"
"2020-05-01","ELORTONDO","4","7","0","11"
"2020-05-01","EL RABON","0","1","0","1"
"2020-05-01","EL TREBOL","0","3","0","3"
"2020-05-01","EMPALME VILLA CONSTITUCION","0","3","0","3"
"2020-05-01","ESPERANZA","1","27","2","30"
"2020-05-01","FIGHIERA","0","3","0","3"
"2020-05-01","FIRMAT","1","14","0","15"
"2020-05-01","FLORENCIA","0","3","0","3"
"2020-05-01","FRANCK","1","7","0","8"
"2020-05-01","FRAY LUIS BELTRAN","4","24","0","28"
"2020-05-01","FRONTERA","0","9","1","10"
"2020-05-01","FUENTES","0","2","0","2"
"2020-05-01","FUNES","5","43","2","50"
"2020-05-01","GABOTO","0","3","0","3"
"2020-05-01","GALVEZ","9","18","1","28"
"2020-05-01","GENERAL LAGOS","0","4","0","4"
"2020-05-01","GESSLER","0","0","1","1"
"2020-05-01","GOBERNADOR CRESPO","0","2","0","2"
"2020-05-01","GODOY","0","1","0","1"
"2020-05-01","GRANADERO BAIGORRIA","2","67","0","69"
"2020-05-01","GREGORIA PEREZ DE DENIS","0","1","0","1"
"2020-05-01","HELVECIA","2","15","1","18"
"2020-05-01","HUGHES","0","5","0","5"
"2020-05-01","HUMBERTO PRIMO","0","1","0","1"
"2020-05-01","HUMBOLDT","1","1","0","2"
"2020-05-01","IBARLUCEA","0","6","0","6"
"2020-05-01","JOSEFINA","0","2","0","2"
"2020-05-01","JUAN B. MOLINA","0","1","0","1"
"2020-05-01","JUNCAL","0","2","0","2"
"2020-05-01","LA BRAVA","0","1","0","1"
"2020-05-01","LA CAROLINA","0","0","1","1"
"2020-05-01","LA CRIOLLA","0","2","0","2"
"2020-05-01","LAGUNA PAIVA","0","5","0","5"
"2020-05-01","LANDETA","0","0","1","1"
"2020-05-01","LANTERI","0","1","0","1"
"2020-05-01","LAS PAREJAS","1","8","0","9"
"2020-05-01","LAS ROSAS","1","7","0","8"
"2020-05-01","LAS TOSCAS","0","3","0","3"
"2020-05-01","LA VANGUARDIA","0","1","0","1"
"2020-05-01","LEHMANN","0","2","0","2"
"2020-05-01","LLAMBI CAMPBELL","3","3","0","6"
"2020-05-01","LOPEZ","0","2","0","2"
"2020-05-01","LOS MOLINOS","0","1","0","1"
"2020-05-01","LOS QUIRQUINCHOS","0","3","0","3"
"2020-05-01","LUIS PALACIOS","0","2","1","3"
"2020-05-01","MACIEL","0","3","1","4"
"2020-05-01","MAGGIOLO","0","2","0","2"
"2020-05-01","MALABRIGO","0","1","0","1"
"2020-05-01","MARGARITA","0","3","0","3"
"2020-05-01","MARIA JUANA","0","2","0","2"
"2020-05-01","MARIA SUSANA","0","3","0","3"
"2020-05-01","MARIA TERESA","0","2","0","2"
"2020-05-01","MAXIMO PAZ","0","1","0","1"
"2020-05-01","MELINCUE","0","1","0","1"
"2020-05-01","MIGUEL TORRES","0","2","0","2"
"2020-05-01","MONJE","0","2","0","2"
"2020-05-01","MONTEFIORE","0","1","0","1"
"2020-05-01","MONTES DE OCA","0","2","0","2"
"2020-05-01","MONTE VERA","0","7","0","7"
"2020-05-01","MURPHY","0","3","0","3"
"2020-05-01","NELSON","0","3","0","3"
"2020-05-01","NUEVO TORINO","0","1","0","1"
"2020-05-01","OLIVEROS","4","9","1","14"
"2020-05-01","PAVON","0","2","0","2"
"2020-05-01","PAVON ARRIBA","0","1","0","1"
"2020-05-01","PEREZ","0","43","1","44"
"2020-05-01","PIAMONTE","0","1","0","1"
"2020-05-01","PILAR","0","1","0","1"
"2020-05-01","PIÑERO","0","1","0","1"
"2020-05-01","PRESIDENTE ROCA","0","1","0","1"
"2020-05-01","PUEBLO ANDINO","2","2","0","4"
"2020-05-01","PUEBLO ESTHER","0","15","0","15"
"2020-05-01","PUEBLO IRIGOYEN","0","1","0","1"
"2020-05-01","PUEBLO URANGA","0","1","0","1"
"2020-05-01","PUERTO GENERAL SAN MARTIN","0","17","0","17"
"2020-05-01","PUERTO RECONQUISTA","0","1","0","1"
"2020-05-01","PUJATO","2","5","0","7"
"2020-05-01","RAFAELA","21","97","4","122"
"2020-05-01","RAMONA","0","2","0","2"
"2020-05-01","RECONQUISTA","0","34","1","35"
"2020-05-01","RECREO","0","16","0","16"
"2020-05-01","RICARDONE","0","8","0","8"
"2020-05-01","RINCON POTRERO","0","1","0","1"
"2020-05-01","ROLDAN","6","29","2","37"
"2020-05-01","ROMANG","0","1","0","1"
"2020-05-01","ROSARIO","98","2353","100","2551"
"2020-05-01","RUFINO","0","14","0","14"
"2020-05-01","SALTO GRANDE","0","2","0","2"
"2020-05-01","SAN ANTONIO DE OBLIGADO","0","1","0","1"
"2020-05-01","SAN CARLOS CENTRO","0","9","0","9"
"2020-05-01","SAN CARLOS SUD","1","0","0","1"
"2020-05-01","SAN CRISTOBAL","0","2","0","2"
"2020-05-01","SANCTI SPIRITU","1","24","0","25"
"2020-05-01","SAN EDUARDO","0","5","0","5"
"2020-05-01","SANFORD","0","1","0","1"
"2020-05-01","SAN FRANCISCO DE SANTA FE","0","1","0","1"
"2020-05-01","SAN GENARO","1","4","0","5"
"2020-05-01","SAN GREGORIO","0","1","0","1"
"2020-05-01","SAN GUILLERMO","0","3","0","3"
"2020-05-01","SAN JAVIER","1","7","0","8"
"2020-05-01","SAN JERONIMO DEL SAUCE","0","1","0","1"
"2020-05-01","SAN JERONIMO NORTE","0","2","0","2"
"2020-05-01","SAN JERONIMO SUD","0","4","0","4"
"2020-05-01","SAN JORGE","0","8","0","8"
"2020-05-01","SAN JOSE DE LA ESQUINA","0","6","0","6"
"2020-05-01","SAN JOSE DEL RINCON","1","12","1","14"
"2020-05-01","SAN JUSTO","0","10","1","11"
"2020-05-01","SAN LORENZO","3","68","3","74"
"2020-05-01","SANTA CLARA DE BUENA VISTA","0","2","0","2"
"2020-05-01","SANTA FE","27","541","24","592"
"2020-05-01","SANTA ISABEL","0","6","1","7"
"2020-05-01","SANTA ROSA DE CALCHINES","0","3","0","3"
"2020-05-01","SANTO DOMINGO","0","1","0","1"
"2020-05-01","SANTO TOME","5","79","1","85"
"2020-05-01","SAN VICENTE","0","2","0","2"
"2020-05-01","SARGENTO CABRAL","0","1","0","1"
"2020-05-01","SARMIENTO","0","2","0","2"
"2020-05-01","SASTRE","0","3","0","3"
"2020-05-01","SAUCE VIEJO","1","17","0","18"
"2020-05-01","SERODINO","0","2","0","2"
"2020-05-01","SOLDINI","0","2","0","2"
"2020-05-01","SUARDI","0","3","0","3"
"2020-05-01","SUNCHALES","0","4","0","4"
"2020-05-01","SUSANA","0","1","0","1"
"2020-05-01","TACURAL","0","2","0","2"
"2020-05-01","TEODELINA","0","7","0","7"
"2020-05-01","TIMBUES","0","3","1","4"
"2020-05-01","TOSTADO","0","4","0","4"
"2020-05-01","TOTORAS","0","3","0","3"
"2020-05-01","VENADO TUERTO","12","130","5","147"
"2020-05-01","VERA","1","16","0","17"
"2020-05-01","VIDELA","0","1","0","1"
"2020-05-01","VILLA ANA","0","1","0","1"
"2020-05-01","VILLA CAÑAS","0","4","0","4"
"2020-05-01","VILLA CONSTITUCION","9","32","1","42"
"2020-05-01","VILLADA","0","1","0","1"
"2020-05-01","VILLA GOBERNADOR GALVEZ","2","123","7","132"
"2020-05-01","VILLA MINETTI","0","3","0","3"
"2020-05-01","VILLA MUGUETA","0","4","0","4"
"2020-05-01","VILLA OCAMPO","0","1","0","1"
"2020-05-01","WHEELWRIGHT","0","5","1","6"
"2020-05-01","ZAVALLA","0","1","0","1"
"2020-05-02","ACEBAL","0","4","0","4"
"2020-05-02","ALBARELLOS","0","1","0","1"
"2020-05-02","ALCORTA","0","4","0","4"
"2020-05-02","ALVAREZ","0","4","0","4"
"2020-05-02","ALVEAR","0","6","0","6"
"2020-05-02","AMENABAR","0","1","0","1"
"2020-05-02","ANGEL GALLARDO","0","4","0","4"
"2020-05-02","ARMSTRONG","2","13","0","15"
"2020-05-02","AROCENA","0","5","0","5"
"2020-05-02","ARROYO AGUIAR","0","1","0","1"
"2020-05-02","ARROYO LEYES","0","8","0","8"
"2020-05-02","ARROYO SECO","2","27","0","29"
"2020-05-02","ARRUFO","0","2","0","2"
"2020-05-02","ARTEAGA","0","2","0","2"
"2020-05-02","AVELLANEDA","0","12","0","12"
"2020-05-02","BARRANCAS","0","3","0","3"
"2020-05-02","BERAVEBU","0","1","0","1"
"2020-05-02","BERNARDO DE IRIGOYEN","0","1","0","1"
"2020-05-02","BIGAND","0","11","0","11"
"2020-05-02","BOMBAL","0","4","0","4"
"2020-05-02","BOUQUET","0","1","0","1"
"2020-05-02","CAFFERATA","0","2","0","2"
"2020-05-02","CALCHAQUI","0","3","0","3"
"2020-05-02","CAÑADA DE GOMEZ","1","26","0","27"
"2020-05-02","CAÑADA DEL UCLE","0","1","0","1"
"2020-05-02","CAPITAN BERMUDEZ","1","40","0","41"
"2020-05-02","CARCARAÑA","0","10","0","10"
"2020-05-02","CARLOS PELLEGRINI","0","3","0","3"
"2020-05-02","CARMEN","0","1","0","1"
"2020-05-02","CARRERAS","0","3","0","3"
"2020-05-02","CARRIZALES","0","1","0","1"
"2020-05-02","CASILDA","2","36","3","41"
"2020-05-02","CAYASTA","1","4","0","5"
"2020-05-02","CERES","0","16","1","17"
"2020-05-02","CHABAS","1","3","0","4"
"2020-05-02","CHAÑAR LADEADO","0","1","0","1"
"2020-05-02","CHOVET","0","1","2","3"
"2020-05-02","CLASON","0","1","0","1"
"2020-05-02","COLONIA MASCIAS","0","1","0","1"
"2020-05-02","COLONIA ROSA","0","1","0","1"
"2020-05-02","CORONDA","0","10","0","10"
"2020-05-02","CORONEL ARNOLD","0","1","0","1"
"2020-05-02","CORONEL RODOLFO S. DOMINGUEZ","0","2","0","2"
"2020-05-02","CORREA","0","5","0","5"
"2020-05-02","DESVIO ARIJON","0","1","0","1"
"2020-05-02","DIAZ","0","1","0","1"
"2020-05-02","DIEGO DE ALVEAR","0","1","0","1"
"2020-05-02","ELORTONDO","4","8","0","12"
"2020-05-02","EL RABON","0","1","0","1"
"2020-05-02","EL TREBOL","0","3","0","3"
"2020-05-02","EMPALME VILLA CONSTITUCION","0","3","0","3"
"2020-05-02","ESPERANZA","1","27","3","31"
"2020-05-02","FIGHIERA","0","3","0","3"
"2020-05-02","FIRMAT","1","14","0","15"
"2020-05-02","FLORENCIA","0","3","0","3"
"2020-05-02","FRANCK","1","7","0","8"
"2020-05-02","FRAY LUIS BELTRAN","4","24","0","28"
"2020-05-02","FRONTERA","0","10","0","10"
"2020-05-02","FUENTES","0","2","0","2"
"2020-05-02","FUNES","5","44","2","51"
"2020-05-02","GABOTO","0","3","0","3"
"2020-05-02","GALVEZ","9","19","0","28"
"2020-05-02","GENERAL LAGOS","0","4","0","4"
"2020-05-02","GESSLER","0","0","1","1"
"2020-05-02","GOBERNADOR CRESPO","0","2","0","2"
"2020-05-02","GODOY","0","1","0","1"
"2020-05-02","GRANADERO BAIGORRIA","2","68","1","71"
"2020-05-02","GREGORIA PEREZ DE DENIS","0","1","0","1"
"2020-05-02","HELVECIA","2","15","1","18"
"2020-05-02","HUGHES","0","5","0","5"
"2020-05-02","HUMBERTO PRIMO","0","1","0","1"
"2020-05-02","HUMBOLDT","1","1","0","2"
"2020-05-02","IBARLUCEA","0","6","0","6"
"2020-05-02","JOSEFINA","0","2","0","2"
"2020-05-02","JUAN B. MOLINA","0","1","0","1"
"2020-05-02","JUNCAL","0","2","0","2"
"2020-05-02","LA BRAVA","0","1","0","1"
"2020-05-02","LA CAROLINA","0","1","0","1"
"2020-05-02","LA CRIOLLA","0","2","0","2"
"2020-05-02","LAGUNA PAIVA","0","5","0","5"
"2020-05-02","LANDETA","0","1","0","1"
"2020-05-02","LANTERI","0","1","0","1"
"2020-05-02","LAS PAREJAS","1","8","0","9"
"2020-05-02","LAS ROSAS","1","7","0","8"
"2020-05-02","LAS TOSCAS","0","3","0","3"
"2020-05-02","LA VANGUARDIA","0","1","0","1"
"2020-05-02","LEHMANN","0","2","0","2"
"2020-05-02","LLAMBI CAMPBELL","3","3","0","6"
"2020-05-02","LOPEZ","0","2","0","2"
"2020-05-02","LOS MOLINOS","0","1","0","1"
"2020-05-02","LOS QUIRQUINCHOS","0","3","0","3"
"2020-05-02","LUIS PALACIOS","0","3","0","3"
"2020-05-02","MACIEL","0","3","1","4"
"2020-05-02","MAGGIOLO","0","2","0","2"
"2020-05-02","MALABRIGO","0","1","0","1"
"2020-05-02","MARGARITA","0","3","0","3"
"2020-05-02","MARIA JUANA","0","2","0","2"
"2020-05-02","MARIA SUSANA","0","3","0","3"
"2020-05-02","MARIA TERESA","0","2","0","2"
"2020-05-02","MAXIMO PAZ","0","1","0","1"
"2020-05-02","MELINCUE","0","1","0","1"
"2020-05-02","MIGUEL TORRES","0","2","0","2"
"2020-05-02","MONJE","0","2","0","2"
"2020-05-02","MONTEFIORE","0","1","0","1"
"2020-05-02","MONTES DE OCA","0","2","0","2"
"2020-05-02","MONTE VERA","0","7","0","7"
"2020-05-02","MURPHY","0","3","0","3"
"2020-05-02","NELSON","0","3","0","3"
"2020-05-02","NUEVO TORINO","0","1","0","1"
"2020-05-02","OLIVEROS","4","9","1","14"
"2020-05-02","PAVON","0","2","0","2"
"2020-05-02","PAVON ARRIBA","0","1","0","1"
"2020-05-02","PEREZ","0","43","1","44"
"2020-05-02","PIAMONTE","0","1","0","1"
"2020-05-02","PILAR","0","1","0","1"
"2020-05-02","PIÑERO","0","1","0","1"
"2020-05-02","PRESIDENTE ROCA","0","1","0","1"
"2020-05-02","PUEBLO ANDINO","2","2","0","4"
"2020-05-02","PUEBLO ESTHER","0","16","0","16"
"2020-05-02","PUEBLO IRIGOYEN","0","1","0","1"
"2020-05-02","PUEBLO URANGA","0","1","0","1"
"2020-05-02","PUERTO GENERAL SAN MARTIN","0","17","0","17"
"2020-05-02","PUERTO RECONQUISTA","0","1","0","1"
"2020-05-02","PUJATO","2","5","0","7"
"2020-05-02","RAFAELA","21","97","6","124"
"2020-05-02","RAMONA","0","2","0","2"
"2020-05-02","RECONQUISTA","0","34","2","36"
"2020-05-02","RECREO","0","16","0","16"
"2020-05-02","RICARDONE","0","8","0","8"
"2020-05-02","RINCON POTRERO","0","1","0","1"
"2020-05-02","ROLDAN","6","31","2","39"
"2020-05-02","ROMANG","0","1","0","1"
"2020-05-02","ROSARIO","98","2432","47","2577"
"2020-05-02","RUFINO","0","14","0","14"
"2020-05-02","SALTO GRANDE","0","2","0","2"
"2020-05-02","SAN ANTONIO DE OBLIGADO","0","1","0","1"
"2020-05-02","SAN CARLOS CENTRO","0","9","0","9"
"2020-05-02","SAN CARLOS SUD","1","0","0","1"
"2020-05-02","SAN CRISTOBAL","0","2","0","2"
"2020-05-02","SANCTI SPIRITU","1","24","0","25"
"2020-05-02","SAN EDUARDO","0","5","0","5"
"2020-05-02","SANFORD","0","1","0","1"
"2020-05-02","SAN FRANCISCO DE SANTA FE","0","1","0","1"
"2020-05-02","SAN GENARO","1","4","0","5"
"2020-05-02","SAN GREGORIO","0","1","0","1"
"2020-05-02","SAN GUILLERMO","0","3","0","3"
"2020-05-02","SAN JAVIER","1","7","0","8"
"2020-05-02","SAN JERONIMO DEL SAUCE","0","1","0","1"
"2020-05-02","SAN JERONIMO NORTE","0","2","0","2"
"2020-05-02","SAN JERONIMO SUD","0","4","0","4"
"2020-05-02","SAN JORGE","0","8","0","8"
"2020-05-02","SAN JOSE DE LA ESQUINA","0","6","0","6"
"2020-05-02","SAN JOSE DEL RINCON","1","12","1","14"
"2020-05-02","SAN JUSTO","0","10","1","11"
"2020-05-02","SAN LORENZO","3","68","3","74"
"2020-05-02","SANTA CLARA DE BUENA VISTA","0","2","0","2"
"2020-05-02","SANTA FE","27","541","32","600"
"2020-05-02","SANTA ISABEL","0","6","1","7"
"2020-05-02","SANTA ROSA DE CALCHINES","0","3","0","3"
"2020-05-02","SANTO DOMINGO","0","1","0","1"
"2020-05-02","SANTO TOME","5","79","1","85"
"2020-05-02","SAN VICENTE","0","2","0","2"
"2020-05-02","SARGENTO CABRAL","0","1","0","1"
"2020-05-02","SARMIENTO","0","2","0","2"
"2020-05-02","SASTRE","0","3","0","3"
"2020-05-02","SAUCE VIEJO","1","17","0","18"
"2020-05-02","SERODINO","0","2","0","2"
"2020-05-02","SOLDINI","0","2","0","2"
"2020-05-02","SUARDI","0","3","0","3"
"2020-05-02","SUNCHALES","0","4","1","5"
"2020-05-02","SUSANA","0","1","0","1"
"2020-05-02","TACURAL","0","2","0","2"
"2020-05-02","TEODELINA","0","7","0","7"
"2020-05-02","TIMBUES","0","3","1","4"
"2020-05-02","TOSTADO","0","4","0","4"
"2020-05-02","TOTORAS","0","3","0","3"
"2020-05-02","VENADO TUERTO","12","140","5","157"
"2020-05-02","VERA","1","16","1","18"
"2020-05-02","VIDELA","0","1","0","1"
"2020-05-02","VILLA ANA","0","1","0","1"
"2020-05-02","VILLA CAÑAS","0","4","0","4"
"2020-05-02","VILLA CONSTITUCION","9","33","1","43"
"2020-05-02","VILLADA","0","1","0","1"
"2020-05-02","VILLA GOBERNADOR GALVEZ","2","129","4","135"
"2020-05-02","VILLA MINETTI","0","3","0","3"
"2020-05-02","VILLA MUGUETA","0","4","0","4"
"2020-05-02","VILLA OCAMPO","0","1","0","1"
"2020-05-02","WHEELWRIGHT","0","5","1","6"
"2020-05-02","ZAVALLA","0","2","0","2"
"2020-05-03","ACEBAL","0","4","0","4"
"2020-05-03","ALBARELLOS","0","1","0","1"
"2020-05-03","ALCORTA","0","4","0","4"
"2020-05-03","ALVAREZ","0","4","0","4"
"2020-05-03","ALVEAR","0","7","1","8"
"2020-05-03","AMENABAR","0","1","0","1"
"2020-05-03","ANGEL GALLARDO","0","4","0","4"
"2020-05-03","ARMSTRONG","2","13","0","15"
"2020-05-03","AROCENA","0","5","0","5"
"2020-05-03","ARROYO AGUIAR","0","1","0","1"
"2020-05-03","ARROYO LEYES","0","8","0","8"
"2020-05-03","ARROYO SECO","2","27","0","29"
"2020-05-03","ARRUFO","0","2","0","2"
"2020-05-03","ARTEAGA","0","2","0","2"
"2020-05-03","AVELLANEDA","0","12","0","12"
"2020-05-03","BARRANCAS","0","3","0","3"
"2020-05-03","BERAVEBU","0","1","0","1"
"2020-05-03","BERNARDO DE IRIGOYEN","0","1","0","1"
"2020-05-03","BIGAND","0","11","0","11"
"2020-05-03","BOMBAL","0","4","0","4"
"2020-05-03","BOUQUET","0","1","0","1"
"2020-05-03","CAFFERATA","0","2","0","2"
"2020-05-03","CALCHAQUI","0","3","0","3"
"2020-05-03","CAÑADA DE GOMEZ","1","26","0","27"
"2020-05-03","CAÑADA DEL UCLE","0","1","0","1"
"2020-05-03","CAPITAN BERMUDEZ","1","40","2","43"
"2020-05-03","CARCARAÑA","0","10","0","10"
"2020-05-03","CARLOS PELLEGRINI","0","3","0","3"
"2020-05-03","CARMEN","0","1","0","1"
"2020-05-03","CARRERAS","0","3","0","3"
"2020-05-03","CARRIZALES","0","1","0","1"
"2020-05-03","CASILDA","2","36","3","41"
"2020-05-03","CAYASTA","1","4","0","5"
"2020-05-03","CERES","0","17","0","17"
"2020-05-03","CHABAS","1","3","0","4"
"2020-05-03","CHAÑAR LADEADO","0","1","0","1"
"2020-05-03","CHOVET","0","1","5","6"
"2020-05-03","CLASON","0","1","0","1"
"2020-05-03","COLONIA MASCIAS","0","1","0","1"
"2020-05-03","COLONIA ROSA","0","1","0","1"
"2020-05-03","CORONDA","0","10","0","10"
"2020-05-03","CORONEL ARNOLD","0","1","0","1"
"2020-05-03","CORONEL RODOLFO S. DOMINGUEZ","0","2","0","2"
"2020-05-03","CORREA","0","5","0","5"
"2020-05-03","DESVIO ARIJON","0","1","0","1"
"2020-05-03","DIAZ","0","1","0","1"
"2020-05-03","DIEGO DE ALVEAR","0","1","0","1"
"2020-05-03","ELORTONDO","4","8","0","12"
"2020-05-03","EL RABON","0","1","0","1"
"2020-05-03","EL TREBOL","0","3","0","3"
"2020-05-03","EMPALME VILLA CONSTITUCION","0","3","0","3"
"2020-05-03","ESPERANZA","1","29","1","31"
"2020-05-03","FIGHIERA","0","3","0","3"
"2020-05-03","FIRMAT","1","14","0","15"
"2020-05-03","FLORENCIA","0","3","0","3"
"2020-05-03","FRANCK","1","7","0","8"
"2020-05-03","FRAY LUIS BELTRAN","4","24","0","28"
"2020-05-03","FRONTERA","0","10","0","10"
"2020-05-03","FUENTES","0","2","0","2"
"2020-05-03","FUNES","5","44","2","51"
"2020-05-03","GABOTO","0","3","0","3"
"2020-05-03","GALVEZ","9","19","0","28"
"2020-05-03","GENERAL LAGOS","0","4","0","4"
"2020-05-03","GESSLER","0","0","1","1"
"2020-05-03","GOBERNADOR CRESPO","0","2","0","2"
"2020-05-03","GODOY","0","1","0","1"
"2020-05-03","GRANADERO BAIGORRIA","2","68","1","71"
"2020-05-03","GREGORIA PEREZ DE DENIS","0","1","0","1"
"2020-05-03","HELVECIA","2","15","1","18"
"2020-05-03","HUGHES","0","5","0","5"
"2020-05-03","HUMBERTO PRIMO","0","1","0","1"
"2020-05-03","HUMBOLDT","1","1","0","2"
"2020-05-03","IBARLUCEA","0","6","0","6"
"2020-05-03","JOSEFINA","0","2","0","2"
"2020-05-03","JUAN B. MOLINA","0","1","0","1"
"2020-05-03","JUNCAL","0","2","0","2"
"2020-05-03","LA BRAVA","0","1","0","1"
"2020-05-03","LA CAROLINA","0","1","0","1"
"2020-05-03","LA CRIOLLA","0","2","0","2"
"2020-05-03","LAGUNA PAIVA","0","5","0","5"
"2020-05-03","LANDETA","0","1","0","1"
"2020-05-03","LANTERI","0","1","0","1"
"2020-05-03","LAS PAREJAS","1","8","0","9"
"2020-05-03","LAS ROSAS","1","7","0","8"
"2020-05-03","LAS TOSCAS","0","3","0","3"
"2020-05-03","LA VANGUARDIA","0","1","0","1"
"2020-05-03","LEHMANN","0","2","0","2"
"2020-05-03","LLAMBI CAMPBELL","3","3","0","6"
"2020-05-03","LOPEZ","0","2","0","2"
"2020-05-03","LOS MOLINOS","0","1","0","1"
"2020-05-03","LOS QUIRQUINCHOS","0","3","0","3"
"2020-05-03","LUIS PALACIOS","0","3","0","3"
"2020-05-03","MACIEL","0","3","1","4"
"2020-05-03","MAGGIOLO","0","2","0","2"
"2020-05-03","MALABRIGO","0","1","0","1"
"2020-05-03","MARGARITA","0","3","0","3"
"2020-05-03","MARIA JUANA","0","2","0","2"
"2020-05-03","MARIA SUSANA","0","3","0","3"
"2020-05-03","MARIA TERESA","0","2","0","2"
"2020-05-03","MAXIMO PAZ","0","1","0","1"
"2020-05-03","MELINCUE","0","1","0","1"
"2020-05-03","MIGUEL TORRES","0","2","0","2"
"2020-05-03","MONJE","0","2","0","2"
"2020-05-03","MONTEFIORE","0","1","0","1"
"2020-05-03","MONTES DE OCA","0","2","0","2"
"2020-05-03","MONTE VERA","0","7","0","7"
"2020-05-03","MURPHY","0","3","0","3"
"2020-05-03","NELSON","0","3","0","3"
"2020-05-03","NUEVO TORINO","0","1","0","1"
"2020-05-03","OLIVEROS","4","9","1","14"
"2020-05-03","PAVON","0","2","0","2"
"2020-05-03","PAVON ARRIBA","0","1","0","1"
"2020-05-03","PEREZ","0","44","3","47"
"2020-05-03","PIAMONTE","0","1","0","1"
"2020-05-03","PILAR","0","1","0","1"
"2020-05-03","PIÑERO","0","1","0","1"
"2020-05-03","PRESIDENTE ROCA","0","1","0","1"
"2020-05-03","PUEBLO ANDINO","2","2","0","4"
"2020-05-03","PUEBLO ESTHER","0","16","0","16"
"2020-05-03","PUEBLO IRIGOYEN","0","1","0","1"
"2020-05-03","PUEBLO URANGA","0","1","0","1"
"2020-05-03","PUERTO GENERAL SAN MARTIN","0","17","0","17"
"2020-05-03","PUERTO RECONQUISTA","0","1","0","1"
"2020-05-03","PUJATO","2","5","0","7"
"2020-05-03","RAFAELA","21","99","4","124"
"2020-05-03","RAMONA","0","2","0","2"
"2020-05-03","RECONQUISTA","0","34","2","36"
"2020-05-03","RECREO","0","16","0","16"
"2020-05-03","RICARDONE","0","8","0","8"
"2020-05-03","RINCON POTRERO","0","1","0","1"
"2020-05-03","ROLDAN","6","32","1","39"
"2020-05-03","ROMANG","0","1","0","1"
"2020-05-03","ROSARIO","98","2464","80","2642"
"2020-05-03","RUFINO","0","14","1","15"
"2020-05-03","SALTO GRANDE","0","2","0","2"
"2020-05-03","SAN ANTONIO DE OBLIGADO","0","1","0","1"
"2020-05-03","SAN CARLOS CENTRO","0","9","0","9"
"2020-05-03","SAN CARLOS SUD","1","0","0","1"
"2020-05-03","SAN CRISTOBAL","0","2","0","2"
"2020-05-03","SANCTI SPIRITU","1","24","0","25"
"2020-05-03","SAN EDUARDO","0","5","0","5"
"2020-05-03","SANFORD","0","1","0","1"
"2020-05-03","SAN FRANCISCO DE SANTA FE","0","1","0","1"
"2020-05-03","SAN GENARO","1","4","0","5"
"2020-05-03","SAN GREGORIO","0","1","0","1"
"2020-05-03","SAN GUILLERMO","0","3","0","3"
"2020-05-03","SAN JAVIER","1","7","0","8"
"2020-05-03","SAN JERONIMO DEL SAUCE","0","1","0","1"
"2020-05-03","SAN JERONIMO NORTE","0","2","0","2"
"2020-05-03","SAN JERONIMO SUD","0","4","0","4"
"2020-05-03","SAN JORGE","0","8","0","8"
"2020-05-03","SAN JOSE DE LA ESQUINA","0","6","0","6"
"2020-05-03","SAN JOSE DEL RINCON","1","12","1","14"
"2020-05-03","SAN JUSTO","0","10","1","11"
"2020-05-03","SAN LORENZO","3","68","4","75"
"2020-05-03","SANTA CLARA DE BUENA VISTA","0","2","0","2"
"2020-05-03","SANTA FE","27","550","24","601"
"2020-05-03","SANTA ISABEL","0","6","1","7"
"2020-05-03","SANTA ROSA DE CALCHINES","0","3","0","3"
"2020-05-03","SANTO DOMINGO","0","1","0","1"
"2020-05-03","SANTO TOME","5","79","1","85"
"2020-05-03","SAN VICENTE","0","2","0","2"
"2020-05-03","SARGENTO CABRAL","0","1","0","1"
"2020-05-03","SARMIENTO","0","2","0","2"
"2020-05-03","SASTRE","0","3","0","3"
"2020-05-03","SAUCE VIEJO","1","17","0","18"
"2020-05-03","SERODINO","0","2","0","2"
"2020-05-03","SOLDINI","0","2","0","2"
"2020-05-03","SUARDI","0","3","0","3"
"2020-05-03","SUNCHALES","0","5","0","5"
"2020-05-03","SUSANA","0","1","0","1"
"2020-05-03","TACURAL","0","2","0","2"
"2020-05-03","TEODELINA","0","7","0","7"
"2020-05-03","TIMBUES","0","3","1","4"
"2020-05-03","TOSTADO","0","4","0","4"
"2020-05-03","TOTORAS","0","3","0","3"
"2020-05-03","VENADO TUERTO","12","140","7","159"
"2020-05-03","VERA","1","17","0","18"
"2020-05-03","VIDELA","0","1","0","1"
"2020-05-03","VILLA ANA","0","1","0","1"
"2020-05-03","VILLA CAÑAS","0","4","0","4"
"2020-05-03","VILLA CONSTITUCION","9","34","0","43"
"2020-05-03","VILLADA","0","1","0","1"
"2020-05-03","VILLA GOBERNADOR GALVEZ","2","130","6","138"
"2020-05-03","VILLA MINETTI","0","3","0","3"
"2020-05-03","VILLA MUGUETA","0","4","0","4"
"2020-05-03","VILLA OCAMPO","0","1","0","1"
"2020-05-03","WHEELWRIGHT","0","5","1","6"
"2020-05-03","ZAVALLA","0","2","0","2"
"2020-05-04","ACEBAL","0","4","0","4"
"2020-05-04","ALBARELLOS","0","1","0","1"
"2020-05-04","ALCORTA","0","4","0","4"
"2020-05-04","ALVAREZ","0","4","0","4"
"2020-05-04","ALVEAR","0","8","0","8"
"2020-05-04","AMENABAR","0","1","0","1"
"2020-05-04","ANGEL GALLARDO","0","4","0","4"
"2020-05-04","AREQUITO","0","0","1","1"
"2020-05-04","ARMSTRONG","2","13","0","15"
"2020-05-04","AROCENA","0","5","0","5"
"2020-05-04","ARROYO AGUIAR","0","1","0","1"
"2020-05-04","ARROYO LEYES","0","8","0","8"
"2020-05-04","ARROYO SECO","2","27","0","29"
"2020-05-04","ARRUFO","0","2","0","2"
"2020-05-04","ARTEAGA","0","2","0","2"
"2020-05-04","AVELLANEDA","0","12","2","14"
"2020-05-04","BARRANCAS","0","3","0","3"
"2020-05-04","BERAVEBU","0","1","0","1"
"2020-05-04","BERNARDO DE IRIGOYEN","0","1","0","1"
"2020-05-04","BIGAND","0","11","0","11"
"2020-05-04","BOMBAL","0","4","0","4"
"2020-05-04","BOUQUET","0","1","0","1"
"2020-05-04","CAFFERATA","0","2","0","2"
"2020-05-04","CALCHAQUI","0","3","0","3"
"2020-05-04","CAÑADA DE GOMEZ","1","28","0","29"
"2020-05-04","CAÑADA DEL UCLE","0","1","0","1"
"2020-05-04","CAPITAN BERMUDEZ","1","42","0","43"
"2020-05-04","CARCARAÑA","0","10","0","10"
"2020-05-04","CARLOS PELLEGRINI","0","3","0","3"
"2020-05-04","CARMEN","0","1","0","1"
"2020-05-04","CARRERAS","0","3","0","3"
"2020-05-04","CARRIZALES","0","1","0","1"
"2020-05-04","CASILDA","2","38","2","42"
"2020-05-04","CAYASTA","1","4","0","5"
"2020-05-04","CERES","0","17","0","17"
"2020-05-04","CHABAS","1","3","0","4"
"2020-05-04","CHAÑAR LADEADO","0","1","0","1"
"2020-05-04","CHOVET","0","1","5","6"
"2020-05-04","CLASON","0","1","0","1"
"2020-05-04","COLONIA MASCIAS","0","1","0","1"
"2020-05-04","COLONIA ROSA","0","1","0","1"
"2020-05-04","CORONDA","0","10","0","10"
"2020-05-04","CORONEL ARNOLD","0","1","0","1"
"2020-05-04","CORONEL RODOLFO S. DOMINGUEZ","0","2","0","2"
"2020-05-04","CORREA","0","5","0","5"
"2020-05-04","DESVIO ARIJON","0","1","0","1"
"2020-05-04","DIAZ","0","1","0","1"
"2020-05-04","DIEGO DE ALVEAR","0","1","0","1"
"2020-05-04","ELORTONDO","4","8","0","12"
"2020-05-04","EL RABON","0","1","0","1"
"2020-05-04","EL TREBOL","0","3","0","3"
"2020-05-04","EMPALME VILLA CONSTITUCION","0","3","0","3"
"2020-05-04","ESPERANZA","1","29","2","32"
"2020-05-04","FIGHIERA","0","3","0","3"
"2020-05-04","FIRMAT","1","14","0","15"
"2020-05-04","FLORENCIA","0","3","0","3"
"2020-05-04","FRANCK","1","7","2","10"
"2020-05-04","FRAY LUIS BELTRAN","4","24","1","29"
"2020-05-04","FRONTERA","0","11","1","12"
"2020-05-04","FUENTES","0","2","0","2"
"2020-05-04","FUNES","5","46","1","52"
"2020-05-04","GABOTO","0","3","1","4"
"2020-05-04","GALVEZ","9","19","0","28"
"2020-05-04","GENERAL LAGOS","0","4","0","4"
"2020-05-04","GESSLER","0","0","1","1"
"2020-05-04","GOBERNADOR CRESPO","0","2","0","2"
"2020-05-04","GODOY","0","1","0","1"
"2020-05-04","GRANADERO BAIGORRIA","2","69","2","73"
"2020-05-04","GREGORIA PEREZ DE DENIS","0","1","0","1"
"2020-05-04","HELVECIA","2","15","1","18"
"2020-05-04","HUGHES","0","5","0","5"
"2020-05-04","HUMBERTO PRIMO","0","1","0","1"
"2020-05-04","HUMBOLDT","1","1","0","2"
"2020-05-04","IBARLUCEA","0","7","0","7"
"2020-05-04","JOSEFINA","0","2","0","2"
"2020-05-04","JUAN B. MOLINA","0","1","0","1"
"2020-05-04","JUNCAL","0","2","0","2"
"2020-05-04","LA BRAVA","0","1","0","1"
"2020-05-04","LA CAROLINA","0","1","0","1"
"2020-05-04","LA CRIOLLA","0","2","0","2"
"2020-05-04","LAGUNA PAIVA","0","5","0","5"
"2020-05-04","LANDETA","0","1","0","1"
"2020-05-04","LANTERI","0","1","0","1"
"2020-05-04","LAS PAREJAS","1","8","0","9"
"2020-05-04","LAS ROSAS","1","8","1","10"
"2020-05-04","LAS TOSCAS","0","3","0","3"
"2020-05-04","LA VANGUARDIA","0","1","0","1"
"2020-05-04","LEHMANN","0","2","0","2"
"2020-05-04","LLAMBI CAMPBELL","3","3","0","6"
"2020-05-04","LOPEZ","0","2","0","2"
"2020-05-04","LOS MOLINOS","0","1","0","1"
"2020-05-04","LOS QUIRQUINCHOS","0","3","0","3"
"2020-05-04","LUIS PALACIOS","0","3","0","3"
"2020-05-04","MACIEL","0","3","1","4"
"2020-05-04","MAGGIOLO","0","2","0","2"
"2020-05-04","MALABRIGO","0","1","0","1"
"2020-05-04","MARGARITA","0","3","0","3"
"2020-05-04","MARIA JUANA","0","2","4","6"
"2020-05-04","MARIA SUSANA","0","3","0","3"
"2020-05-04","MARIA TERESA","0","2","0","2"
"2020-05-04","MAXIMO PAZ","0","1","0","1"
"2020-05-04","MELINCUE","0","1","0","1"
"2020-05-04","MIGUEL TORRES","0","2","0","2"
"2020-05-04","MONJE","0","2","0","2"
"2020-05-04","MONTEFIORE","0","1","0","1"
"2020-05-04","MONTES DE OCA","0","2","0","2"
"2020-05-04","MONTE VERA","0","7","1","8"
"2020-05-04","MURPHY","0","3","0","3"
"2020-05-04","NELSON","0","3","0","3"
"2020-05-04","NUEVO TORINO","0","1","0","1"
"2020-05-04","OLIVEROS","4","9","1","14"
"2020-05-04","PAVON","0","2","0","2"
"2020-05-04","PAVON ARRIBA","0","1","0","1"
"2020-05-04","PEREZ","0","46","1","47"
"2020-05-04","PIAMONTE","0","1","0","1"
"2020-05-04","PILAR","0","1","0","1"
"2020-05-04","PIÑERO","0","1","0","1"
"2020-05-04","PRESIDENTE ROCA","0","1","0","1"
"2020-05-04","PUEBLO ANDINO","2","3","0","5"
"2020-05-04","PUEBLO ESTHER","0","16","0","16"
"2020-05-04","PUEBLO IRIGOYEN","0","1","0","1"
"2020-05-04","PUEBLO URANGA","0","1","0","1"
"2020-05-04","PUERTO GENERAL SAN MARTIN","0","17","0","17"
"2020-05-04","PUERTO RECONQUISTA","0","1","0","1"
"2020-05-04","PUJATO","2","5","0","7"
"2020-05-04","RAFAELA","21","99","10","130"
"2020-05-04","RAMONA","0","2","0","2"
"2020-05-04","RECONQUISTA","0","36","2","38"
"2020-05-04","RECREO","0","16","1","17"
"2020-05-04","RICARDONE","0","8","0","8"
"2020-05-04","RINCON POTRERO","0","1","0","1"
"2020-05-04","ROLDAN","6","33","0","39"
"2020-05-04","ROMANG","0","1","0","1"
"2020-05-04","ROSARIO","98","2537","59","2694"
"2020-05-04","RUFINO","0","19","0","19"
"2020-05-04","SALTO GRANDE","0","2","0","2"
"2020-05-04","SAN ANTONIO DE OBLIGADO","0","1","0","1"
"2020-05-04","SAN CARLOS CENTRO","0","9","0","9"
"2020-05-04","SAN CARLOS SUD","1","0","0","1"
"2020-05-04","SAN CRISTOBAL","0","2","1","3"
"2020-05-04","SANCTI SPIRITU","1","26","0","27"
"2020-05-04","SAN EDUARDO","0","5","0","5"
"2020-05-04","SANFORD","0","1","0","1"
"2020-05-04","SAN FRANCISCO DE SANTA FE","0","1","0","1"
"2020-05-04","SAN GENARO","1","4","0","5"
"2020-05-04","SAN GREGORIO","0","3","0","3"
"2020-05-04","SAN GUILLERMO","0","3","0","3"
"2020-05-04","SAN JAVIER","1","7","0","8"
"2020-05-04","SAN JERONIMO DEL SAUCE","0","1","0","1"
"2020-05-04","SAN JERONIMO NORTE","0","2","0","2"
"2020-05-04","SAN JERONIMO SUD","0","4","0","4"
"2020-05-04","SAN JORGE","0","8","0","8"
"2020-05-04","SAN JOSE DE LA ESQUINA","0","6","0","6"
"2020-05-04","SAN JOSE DEL RINCON","1","12","1","14"
"2020-05-04","SAN JUSTO","0","11","1","12"
"2020-05-04","SAN LORENZO","3","69","4","76"
"2020-05-04","SANTA CLARA DE BUENA VISTA","0","2","0","2"
"2020-05-04","SANTA FE","27","554","29","610"
"2020-05-04","SANTA ISABEL","0","6","1","7"
"2020-05-04","SANTA ROSA DE CALCHINES","0","3","0","3"
"2020-05-04","SANTO DOMINGO","0","1","0","1"
"2020-05-04","SANTO TOME","5","80","1","86"
"2020-05-04","SAN VICENTE","0","2","0","2"
"2020-05-04","SARGENTO CABRAL","0","1","0","1"
"2020-05-04","SARMIENTO","0","2","0","2"
"2020-05-04","SASTRE","0","3","0","3"
"2020-05-04","SAUCE VIEJO","1","17","1","19"
"2020-05-04","SERODINO","0","2","0","2"
"2020-05-04","SOLDINI","0","2","0","2"
"2020-05-04","SUARDI","0","3","0","3"
"2020-05-04","SUNCHALES","0","5","0","5"
"2020-05-04","SUSANA","0","1","0","1"
"2020-05-04","TACURAL","0","2","0","2"
"2020-05-04","TEODELINA","0","7","0","7"
"2020-05-04","TIMBUES","0","3","1","4"
"2020-05-04","TOSTADO","0","4","0","4"
"2020-05-04","TOTORAS","0","3","0","3"
"2020-05-04","VENADO TUERTO","12","154","9","175"
"2020-05-04","VERA","1","17","1","19"
"2020-05-04","VIDELA","0","1","0","1"
"2020-05-04","VILLA ANA","0","1","0","1"
"2020-05-04","VILLA CAÑAS","0","4","0","4"
"2020-05-04","VILLA CONSTITUCION","9","34","1","44"
"2020-05-04","VILLADA","0","1","0","1"
"2020-05-04","VILLA GOBERNADOR GALVEZ","2","133","5","140"
"2020-05-04","VILLA MINETTI","0","3","0","3"
"2020-05-04","VILLA MUGUETA","0","4","0","4"
"2020-05-04","VILLA OCAMPO","0","1","0","1"
"2020-05-04","WHEELWRIGHT","0","5","1","6"
"2020-05-04","ZAVALLA","0","2","0","2"
"2020-05-05","ACEBAL","0","4","0","4"
"2020-05-05","ALBARELLOS","0","1","0","1"
"2020-05-05","ALCORTA","0","4","0","4"
"2020-05-05","ALVAREZ","0","4","0","4"
"2020-05-05","ALVEAR","0","8","0","8"
"2020-05-05","AMENABAR","0","1","0","1"
"2020-05-05","ANGEL GALLARDO","0","4","0","4"
"2020-05-05","AREQUITO","0","1","0","1"
"2020-05-05","ARMSTRONG","2","14","0","16"
"2020-05-05","AROCENA","0","5","0","5"
"2020-05-05","ARROYO AGUIAR","0","1","0","1"
"2020-05-05","ARROYO LEYES","0","8","0","8"
"2020-05-05","ARROYO SECO","2","27","0","29"
"2020-05-05","ARRUFO","0","2","0","2"
"2020-05-05","ARTEAGA","0","2","0","2"
"2020-05-05","AVELLANEDA","0","12","2","14"
"2020-05-05","BARRANCAS","0","3","0","3"
"2020-05-05","BERAVEBU","0","1","0","1"
"2020-05-05","BERNARDO DE IRIGOYEN","0","1","0","1"
"2020-05-05","BIGAND","0","11","0","11"
"2020-05-05","BOMBAL","0","4","0","4"
"2020-05-05","BOUQUET","0","1","0","1"
"2020-05-05","CAFFERATA","0","2","0","2"
"2020-05-05","CALCHAQUI","0","3","0","3"
"2020-05-05","CAÑADA DE GOMEZ","1","28","0","29"
"2020-05-05","CAÑADA DEL UCLE","0","1","0","1"
"2020-05-05","CAPITAN BERMUDEZ","1","42","2","45"
"2020-05-05","CARCARAÑA","0","10","0","10"
"2020-05-05","CARLOS PELLEGRINI","0","3","0","3"
"2020-05-05","CARMEN","0","1","0","1"
"2020-05-05","CARRERAS","0","3","0","3"
"2020-05-05","CARRIZALES","0","1","0","1"
"2020-05-05","CASILDA","2","39","3","44"
"2020-05-05","CAYASTA","1","4","0","5"
"2020-05-05","CERES","0","17","0","17"
"2020-05-05","CHABAS","1","3","1","5"
"2020-05-05","CHAÑAR LADEADO","0","1","0","1"
"2020-05-05","CHOVET","0","6","0","6"
"2020-05-05","CLASON","0","1","0","1"
"2020-05-05","COLONIA MASCIAS","0","1","0","1"
"2020-05-05","COLONIA ROSA","0","1","0","1"
"2020-05-05","CORONDA","0","10","0","10"
"2020-05-05","CORONEL ARNOLD","0","1","0","1"
"2020-05-05","CORONEL RODOLFO S. DOMINGUEZ","0","2","0","2"
"2020-05-05","CORREA","0","5","0","5"
"2020-05-05","DESVIO ARIJON","0","1","0","1"
"2020-05-05","DIAZ","0","1","0","1"
"2020-05-05","DIEGO DE ALVEAR","0","1","0","1"
"2020-05-05","ELORTONDO","4","8","0","12"
"2020-05-05","EL RABON","0","1","0","1"
"2020-05-05","EL TREBOL","0","3","1","4"
"2020-05-05","EMPALME VILLA CONSTITUCION","0","3","0","3"
"2020-05-05","ESPERANZA","1","30","3","34"
"2020-05-05","FIGHIERA","0","3","0","3"
"2020-05-05","FIRMAT","1","15","0","16"
"2020-05-05","FLORENCIA","0","3","0","3"
"2020-05-05","FRANCK","1","8","1","10"
"2020-05-05","FRAY LUIS BELTRAN","4","24","2","30"
"2020-05-05","FRONTERA","0","12","2","14"
"2020-05-05","FUENTES","0","2","0","2"
"2020-05-05","FUNES","5","47","3","55"
"2020-05-05","GABOTO","0","3","1","4"
"2020-05-05","GALVEZ","9","19","0","28"
"2020-05-05","GENERAL LAGOS","0","4","0","4"
"2020-05-05","GESSLER","0","0","1","1"
"2020-05-05","GOBERNADOR CRESPO","0","2","0","2"
"2020-05-05","GODOY","0","1","0","1"
"2020-05-05","GRANADERO BAIGORRIA","2","74","1","77"
"2020-05-05","GREGORIA PEREZ DE DENIS","0","1","0","1"
"2020-05-05","HELVECIA","2","15","2","19"
"2020-05-05","HUGHES","0","5","0","5"
"2020-05-05","HUMBERTO PRIMO","0","1","0","1"
"2020-05-05","HUMBOLDT","1","1","0","2"
"2020-05-05","IBARLUCEA","0","7","0","7"
"2020-05-05","JOSEFINA","0","2","0","2"
"2020-05-05","JUAN B. MOLINA","0","1","0","1"
"2020-05-05","JUNCAL","0","2","0","2"
"2020-05-05","LA BRAVA","0","1","0","1"
"2020-05-05","LA CAROLINA","0","1","0","1"
"2020-05-05","LA CRIOLLA","0","2","0","2"
"2020-05-05","LAGUNA PAIVA","0","5","0","5"
"2020-05-05","LANDETA","0","1","0","1"
"2020-05-05","LANTERI","0","1","0","1"
"2020-05-05","LAS PAREJAS","1","8","0","9"
"2020-05-05","LAS ROSAS","1","8","1","10"
"2020-05-05","LAS TOSCAS","0","3","0","3"
"2020-05-05","LA VANGUARDIA","0","1","0","1"
"2020-05-05","LEHMANN","0","2","0","2"
"2020-05-05","LLAMBI CAMPBELL","3","3","0","6"
"2020-05-05","LOPEZ","0","2","0","2"
"2020-05-05","LOS MOLINOS","0","1","0","1"
"2020-05-05","LOS QUIRQUINCHOS","0","3","0","3"
"2020-05-05","LUIS PALACIOS","0","3","0","3"
"2020-05-05","MACIEL","0","3","2","5"
"2020-05-05","MAGGIOLO","0","2","0","2"
"2020-05-05","MALABRIGO","0","1","0","1"
"2020-05-05","MARGARITA","0","3","0","3"
"2020-05-05","MARIA JUANA","1","4","1","6"
"2020-05-05","MARIA SUSANA","0","3","0","3"
"2020-05-05","MARIA TERESA","0","2","0","2"
"2020-05-05","MAXIMO PAZ","0","1","0","1"
"2020-05-05","MELINCUE","0","1","0","1"
"2020-05-05","MIGUEL TORRES","0","2","1","3"
"2020-05-05","MONJE","0","2","0","2"
"2020-05-05","MONTEFIORE","0","1","0","1"
"2020-05-05","MONTES DE OCA","0","2","0","2"
"2020-05-05","MONTE VERA","0","7","1","8"
"2020-05-05","MURPHY","0","3","0","3"
"2020-05-05","NELSON","0","3","0","3"
"2020-05-05","NUEVO TORINO","0","1","0","1"
"2020-05-05","OLIVEROS","4","9","1","14"
"2020-05-05","PAVON","0","2","0","2"
"2020-05-05","PAVON ARRIBA","0","1","0","1"
"2020-05-05","PEREZ","0","46","1","47"
"2020-05-05","PIAMONTE","0","1","0","1"
"2020-05-05","PILAR","0","1","0","1"
"2020-05-05","PIÑERO","0","1","0","1"
"2020-05-05","PLAZA CLUCELLAS","0","0","4","4"
"2020-05-05","PRESIDENTE ROCA","0","1","0","1"
"2020-05-05","PUEBLO ANDINO","2","3","0","5"
"2020-05-05","PUEBLO ESTHER","0","16","1","17"
"2020-05-05","PUEBLO IRIGOYEN","0","1","0","1"
"2020-05-05","PUEBLO URANGA","0","1","0","1"
"2020-05-05","PUERTO GENERAL SAN MARTIN","0","17","1","18"
"2020-05-05","PUERTO RECONQUISTA","0","1","0","1"
"2020-05-05","PUJATO","2","6","1","9"
"2020-05-05","RAFAELA","21","104","9","134"
"2020-05-05","RAMONA","0","2","0","2"
"2020-05-05","RECONQUISTA","0","37","1","38"
"2020-05-05","RECREO","0","16","1","17"
"2020-05-05","RICARDONE","0","8","0","8"
"2020-05-05","RINCON POTRERO","0","1","0","1"
"2020-05-05","ROLDAN","6","34","0","40"
"2020-05-05","ROMANG","0","1","0","1"
"2020-05-05","ROSARIO","98","2597","65","2760"
"2020-05-05","RUFINO","0","19","0","19"
"2020-05-05","SALTO GRANDE","0","2","0","2"
"2020-05-05","SAN ANTONIO DE OBLIGADO","0","1","0","1"
"2020-05-05","SAN CARLOS CENTRO","0","9","0","9"
"2020-05-05","SAN CARLOS SUD","1","0","0","1"
"2020-05-05","SAN CRISTOBAL","0","3","0","3"
"2020-05-05","SANCTI SPIRITU","1","26","0","27"
"2020-05-05","SAN EDUARDO","0","5","0","5"
"2020-05-05","SANFORD","0","1","0","1"
"2020-05-05","SAN FRANCISCO DE SANTA FE","0","1","0","1"
"2020-05-05","SAN GENARO","1","4","0","5"
"2020-05-05","SAN GREGORIO","0","3","0","3"
"2020-05-05","SAN GUILLERMO","0","3","0","3"
"2020-05-05","SAN JAVIER","1","7","0","8"
"2020-05-05","SAN JERONIMO DEL SAUCE","0","1","0","1"
"2020-05-05","SAN JERONIMO NORTE","0","2","0","2"
"2020-05-05","SAN JERONIMO SUD","0","4","0","4"
"2020-05-05","SAN JORGE","0","8","0","8"
"2020-05-05","SAN JOSE DE LA ESQUINA","0","6","0","6"
"2020-05-05","SAN JOSE DEL RINCON","1","12","1","14"
"2020-05-05","SAN JUSTO","0","12","0","12"
"2020-05-05","SAN LORENZO","3","70","5","78"
"2020-05-05","SANTA CLARA DE BUENA VISTA","0","2","0","2"
"2020-05-05","SANTA FE","27","562","29","618"
"2020-05-05","SANTA ISABEL","0","6","1","7"
"2020-05-05","SANTA ROSA DE CALCHINES","0","3","0","3"
"2020-05-05","SANTO DOMINGO","0","1","0","1"
"2020-05-05","SANTO TOME","5","81","1","87"
"2020-05-05","SAN VICENTE","0","2","0","2"
"2020-05-05","SARGENTO CABRAL","0","1","0","1"
"2020-05-05","SARMIENTO","0","2","0","2"
"2020-05-05","SASTRE","0","3","0","3"
"2020-05-05","SAUCE VIEJO","1","17","1","19"
"2020-05-05","SERODINO","0","2","0","2"
"2020-05-05","SOLDINI","0","2","0","2"
"2020-05-05","SUARDI","0","3","0","3"
"2020-05-05","SUNCHALES","0","5","0","5"
"2020-05-05","SUSANA","0","1","0","1"
"2020-05-05","TACURAL","0","2","0","2"
"2020-05-05","TEODELINA","0","7","0","7"
"2020-05-05","TIMBUES","0","4","1","5"
"2020-05-05","TOSTADO","0","4","0","4"
"2020-05-05","TOTORAS","0","3","0","3"
"2020-05-05","VENADO TUERTO","12","165","5","182"
"2020-05-05","VERA","1","18","0","19"
"2020-05-05","VIDELA","0","1","0","1"
"2020-05-05","VILLA ANA","0","1","0","1"
"2020-05-05","VILLA CAÑAS","0","4","0","4"
"2020-05-05","VILLA CONSTITUCION","9","35","1","45"
"2020-05-05","VILLADA","0","1","0","1"
"2020-05-05","VILLA GOBERNADOR GALVEZ","2","136","4","142"
"2020-05-05","VILLA MINETTI","0","3","0","3"
"2020-05-05","VILLA MUGUETA","0","4","0","4"
"2020-05-05","VILLA OCAMPO","0","1","0","1"
"2020-05-05","WHEELWRIGHT","0","5","1","6"
"2020-05-05","ZAVALLA","0","2","0","2"
"2020-05-06","ACEBAL","0","4","0","4"
"2020-05-06","ALBARELLOS","0","1","0","1"
"2020-05-06","ALCORTA","0","5","0","5"
"2020-05-06","ALVAREZ","0","4","0","4"
"2020-05-06","ALVEAR","0","8","0","8"
"2020-05-06","AMENABAR","0","1","0","1"
"2020-05-06","ANGEL GALLARDO","0","4","0","4"
"2020-05-06","AREQUITO","0","1","0","1"
"2020-05-06","ARMSTRONG","2","14","0","16"
"2020-05-06","AROCENA","0","5","0","5"
"2020-05-06","ARROYO AGUIAR","0","1","0","1"
"2020-05-06","ARROYO LEYES","0","8","0","8"
"2020-05-06","ARROYO SECO","2","27","0","29"
"2020-05-06","ARRUFO","0","2","0","2"
"2020-05-06","ARTEAGA","0","2","0","2"
"2020-05-06","AVELLANEDA","0","14","0","14"
"2020-05-06","BARRANCAS","0","3","0","3"
"2020-05-06","BERAVEBU","0","1","0","1"
"2020-05-06","BERNARDO DE IRIGOYEN","0","1","0","1"
"2020-05-06","BIGAND","0","11","0","11"
"2020-05-06","BOMBAL","0","4","0","4"
"2020-05-06","BOUQUET","0","1","0","1"
"2020-05-06","CAFFERATA","0","2","0","2"
"2020-05-06","CALCHAQUI","0","3","0","3"
"2020-05-06","CAÑADA DE GOMEZ","1","30","0","31"
"2020-05-06","CAÑADA DEL UCLE","0","1","0","1"
"2020-05-06","CAPITAN BERMUDEZ","1","43","2","46"
"2020-05-06","CARCARAÑA","0","11","0","11"
"2020-05-06","CARLOS PELLEGRINI","0","4","0","4"
"2020-05-06","CARMEN","0","1","0","1"
"2020-05-06","CARRERAS","0","3","0","3"
"2020-05-06","CARRIZALES","0","1","0","1"
"2020-05-06","CASILDA","2","41","1","44"
"2020-05-06","CAYASTA","1","4","0","5"
"2020-05-06","CERES","0","17","0","17"
"2020-05-06","CHABAS","1","4","0","5"
"2020-05-06","CHAÑAR LADEADO","0","1","0","1"
"2020-05-06","CHOVET","0","7","0","7"
"2020-05-06","CLASON","0","1","0","1"
"2020-05-06","COLONIA MASCIAS","0","1","0","1"
"2020-05-06","COLONIA ROSA","0","1","0","1"
"2020-05-06","CORONDA","0","10","0","10"
"2020-05-06","CORONEL ARNOLD","0","1","0","1"
"2020-05-06","CORONEL RODOLFO S. DOMINGUEZ","0","2","0","2"
"2020-05-06","CORREA","0","5","0","5"
"2020-05-06","DESVIO ARIJON","0","1","0","1"
"2020-05-06","DIAZ","0","1","0","1"
"2020-05-06","DIEGO DE ALVEAR","0","1","0","1"
"2020-05-06","ELORTONDO","4","8","0","12"
"2020-05-06","EL RABON","0","1","0","1"
"2020-05-06","EL TREBOL","0","4","0","4"
"2020-05-06","EMPALME VILLA CONSTITUCION","0","3","0","3"
"2020-05-06","ESPERANZA","1","32","1","34"
"2020-05-06","FIGHIERA","0","3","0","3"
"2020-05-06","FIRMAT","1","15","0","16"
"2020-05-06","FLORENCIA","0","3","0","3"
"2020-05-06","FRANCK","1","9","0","10"
"2020-05-06","FRAY LUIS BELTRAN","4","27","0","31"
"2020-05-06","FRONTERA","0","12","9","21"
"2020-05-06","FUENTES","0","2","0","2"
"2020-05-06","FUNES","5","49","1","55"
"2020-05-06","GABOTO","0","3","1","4"
"2020-05-06","GALVEZ","9","19","0","28"
"2020-05-06","GENERAL LAGOS","0","4","0","4"
"2020-05-06","GESSLER","0","0","1","1"
"2020-05-06","GOBERNADOR CRESPO","0","2","0","2"
"2020-05-06","GODOY","0","1","0","1"
"2020-05-06","GRANADERO BAIGORRIA","2","78","3","83"
"2020-05-06","GREGORIA PEREZ DE DENIS","0","1","0","1"
"2020-05-06","HELVECIA","2","16","1","19"
"2020-05-06","HUGHES","0","5","0","5"
"2020-05-06","HUMBERTO PRIMO","0","1","0","1"
"2020-05-06","HUMBOLDT","1","1","0","2"
"2020-05-06","IBARLUCEA","0","8","0","8"
"2020-05-06","JOSEFINA","0","2","0","2"
"2020-05-06","JUAN B. MOLINA","0","1","0","1"
"2020-05-06","JUNCAL","0","2","0","2"
"2020-05-06","LA BRAVA","0","1","0","1"
"2020-05-06","LA CAROLINA","0","1","0","1"
"2020-05-06","LA CRIOLLA","0","2","1","3"
"2020-05-06","LAGUNA PAIVA","0","5","0","5"
"2020-05-06","LANDETA","0","1","0","1"
"2020-05-06","LANTERI","0","1","0","1"
"2020-05-06","LAS PAREJAS","1","8","0","9"
"2020-05-06","LAS ROSAS","1","9","0","10"
"2020-05-06","LAS TOSCAS","0","3","0","3"
"2020-05-06","LA VANGUARDIA","0","1","0","1"
"2020-05-06","LEHMANN","0","2","0","2"
"2020-05-06","LLAMBI CAMPBELL","3","3","0","6"
"2020-05-06","LOPEZ","0","2","0","2"
"2020-05-06","LOS MOLINOS","0","1","0","1"
"2020-05-06","LOS QUIRQUINCHOS","0","3","0","3"
"2020-05-06","LUIS PALACIOS","0","3","0","3"
"2020-05-06","MACIEL","0","4","1","5"
"2020-05-06","MAGGIOLO","0","3","0","3"
"2020-05-06","MALABRIGO","0","1","0","1"
"2020-05-06","MARGARITA","0","3","0","3"
"2020-05-06","MARIA JUANA","1","5","0","6"
"2020-05-06","MARIA SUSANA","0","3","0","3"
"2020-05-06","MARIA TERESA","0","2","0","2"
"2020-05-06","MAXIMO PAZ","0","2","0","2"
"2020-05-06","MELINCUE","0","1","0","1"
"2020-05-06","MIGUEL TORRES","0","3","0","3"
"2020-05-06","MONJE","0","2","0","2"
"2020-05-06","MONTEFIORE","0","1","0","1"
"2020-05-06","MONTES DE OCA","0","2","0","2"
"2020-05-06","MONTE VERA","0","8","0","8"
"2020-05-06","MURPHY","0","3","0","3"
"2020-05-06","NELSON","0","3","0","3"
"2020-05-06","NUEVO TORINO","0","1","0","1"
"2020-05-06","OLIVEROS","4","9","1","14"
"2020-05-06","PAVON","0","2","0","2"
"2020-05-06","PAVON ARRIBA","0","1","0","1"
"2020-05-06","PEREZ","0","46","1","47"
"2020-05-06","PIAMONTE","0","1","0","1"
"2020-05-06","PILAR","0","1","0","1"
"2020-05-06","PIÑERO","0","1","0","1"
"2020-05-06","PLAZA CLUCELLAS","0","0","4","4"
"2020-05-06","PRESIDENTE ROCA","0","1","0","1"
"2020-05-06","PUEBLO ANDINO","2","3","0","5"
"2020-05-06","PUEBLO ESTHER","0","17","0","17"
"2020-05-06","PUEBLO IRIGOYEN","0","1","0","1"
"2020-05-06","PUEBLO URANGA","0","1","0","1"
"2020-05-06","PUERTO GENERAL SAN MARTIN","0","19","1","20"
"2020-05-06","PUERTO RECONQUISTA","0","1","0","1"
"2020-05-06","PUJATO","2","7","0","9"
"2020-05-06","RAFAELA","21","106","8","135"
"2020-05-06","RAMONA","0","2","0","2"
"2020-05-06","RECONQUISTA","0","37","1","38"
"2020-05-06","RECREO","0","17","0","17"
"2020-05-06","RICARDONE","0","8","0","8"
"2020-05-06","RINCON POTRERO","0","1","0","1"
"2020-05-06","ROLDAN","6","35","2","43"
"2020-05-06","ROMANG","0","1","0","1"
"2020-05-06","ROSARIO","98","2668","37","2803"
"2020-05-06","RUFINO","0","19","0","19"
"2020-05-06","SALTO GRANDE","0","2","0","2"
"2020-05-06","SAN ANTONIO DE OBLIGADO","0","1","0","1"
"2020-05-06","SAN CARLOS CENTRO","0","9","0","9"
"2020-05-06","SAN CARLOS SUD","1","0","0","1"
"2020-05-06","SAN CRISTOBAL","0","3","0","3"
"2020-05-06","SANCTI SPIRITU","1","26","0","27"
"2020-05-06","SAN EDUARDO","0","5","0","5"
"2020-05-06","SANFORD","0","1","0","1"
"2020-05-06","SAN FRANCISCO DE SANTA FE","0","1","0","1"
"2020-05-06","SAN GENARO","1","4","0","5"
"2020-05-06","SAN GREGORIO","0","3","0","3"
"2020-05-06","SAN GUILLERMO","0","3","0","3"
"2020-05-06","SAN JAVIER","1","7","1","9"
"2020-05-06","SAN JERONIMO DEL SAUCE","0","1","0","1"
"2020-05-06","SAN JERONIMO NORTE","0","2","0","2"
"2020-05-06","SAN JERONIMO SUD","0","4","0","4"
"2020-05-06","SAN JORGE","0","8","0","8"
"2020-05-06","SAN JOSE DE LA ESQUINA","0","7","0","7"
"2020-05-06","SAN JOSE DEL RINCON","1","12","1","14"
"2020-05-06","SAN JUSTO","0","12","0","12"
"2020-05-06","SAN LORENZO","3","74","5","82"
"2020-05-06","SANTA CLARA DE BUENA VISTA","0","2","0","2"
"2020-05-06","SANTA FE","27","572","27","626"
"2020-05-06","SANTA ISABEL","0","6","1","7"
"2020-05-06","SANTA ROSA DE CALCHINES","0","3","0","3"
"2020-05-06","SANTO DOMINGO","0","1","0","1"
"2020-05-06","SANTO TOME","5","82","1","88"
"2020-05-06","SAN VICENTE","0","2","0","2"
"2020-05-06","SARGENTO CABRAL","0","1","0","1"
"2020-05-06","SARMIENTO","0","2","0","2"
"2020-05-06","SASTRE","0","3","0","3"
"2020-05-06","SAUCE VIEJO","1","17","1","19"
"2020-05-06","SERODINO","0","2","0","2"
"2020-05-06","SOLDINI","0","2","0","2"
"2020-05-06","SUARDI","0","3","1","4"
"2020-05-06","SUNCHALES","0","5","0","5"
"2020-05-06","SUSANA","0","1","0","1"
"2020-05-06","TACURAL","0","2","0","2"
"2020-05-06","TEODELINA","0","7","0","7"
"2020-05-06","TIMBUES","0","4","1","5"
"2020-05-06","TOSTADO","0","4","0","4"
"2020-05-06","TOTORAS","0","3","0","3"
"2020-05-06","VENADO TUERTO","12","171","5","188"
"2020-05-06","VERA","1","18","0","19"
"2020-05-06","VIDELA","0","1","0","1"
"2020-05-06","VILLA ANA","0","1","0","1"
"2020-05-06","VILLA CAÑAS","0","4","0","4"
"2020-05-06","VILLA CONSTITUCION","9","36","0","45"
"2020-05-06","VILLADA","0","1","0","1"
"2020-05-06","VILLA GOBERNADOR GALVEZ","2","138","6","146"
"2020-05-06","VILLA MINETTI","0","3","0","3"
"2020-05-06","VILLA MUGUETA","0","4","0","4"
"2020-05-06","VILLA OCAMPO","0","1","0","1"
"2020-05-06","WHEELWRIGHT","0","5","1","6"
"2020-05-06","ZAVALLA","0","2","0","2"
"2020-05-07","ACEBAL","0","4","0","4"
"2020-05-07","ALBARELLOS","0","1","0","1"
"2020-05-07","ALCORTA","0","5","0","5"
"2020-05-07","ALVAREZ","0","4","1","5"
"2020-05-07","ALVEAR","0","8","0","8"
"2020-05-07","AMENABAR","0","1","0","1"
"2020-05-07","ANGEL GALLARDO","0","4","0","4"
"2020-05-07","AREQUITO","0","1","0","1"
"2020-05-07","ARMSTRONG","2","14","0","16"
"2020-05-07","AROCENA","0","5","0","5"
"2020-05-07","ARROYO AGUIAR","0","1","0","1"
"2020-05-07","ARROYO LEYES","0","8","0","8"
"2020-05-07","ARROYO SECO","2","27","0","29"
"2020-05-07","ARRUFO","0","2","0","2"
"2020-05-07","ARTEAGA","0","2","0","2"
"2020-05-07","AVELLANEDA","0","14","0","14"
"2020-05-07","BARRANCAS","0","3","0","3"
"2020-05-07","BERAVEBU","0","1","0","1"
"2020-05-07","BERNARDO DE IRIGOYEN","0","1","1","2"
"2020-05-07","BIGAND","0","11","0","11"
"2020-05-07","BOMBAL","0","4","0","4"
"2020-05-07","BOUQUET","0","1","0","1"
"2020-05-07","CAFFERATA","0","2","0","2"
"2020-05-07","CALCHAQUI","0","3","0","3"
"2020-05-07","CAÑADA DE GOMEZ","1","32","0","33"
"2020-05-07","CAÑADA DEL UCLE","0","1","0","1"
"2020-05-07","CAPITAN BERMUDEZ","1","46","1","48"
"2020-05-07","CARCARAÑA","0","11","0","11"
"2020-05-07","CARLOS PELLEGRINI","0","4","0","4"
"2020-05-07","CARMEN","0","1","0","1"
"2020-05-07","CARRERAS","0","3","0","3"
"2020-05-07","CARRIZALES","0","1","0","1"
"2020-05-07","CASILDA","2","41","1","44"
"2020-05-07","CAYASTA","1","4","0","5"
"2020-05-07","CERES","0","17","0","17"
"2020-05-07","CHABAS","1","4","0","5"
"2020-05-07","CHAÑAR LADEADO","0","1","0","1"
"2020-05-07","CHOVET","0","8","0","8"
"2020-05-07","CLASON","0","1","0","1"
"2020-05-07","COLONIA MASCIAS","0","1","0","1"
"2020-05-07","COLONIA ROSA","0","1","0","1"
"2020-05-07","CORONDA","0","10","0","10"
"2020-05-07","CORONEL ARNOLD","0","1","0","1"
"2020-05-07","CORONEL BOGADO","0","1","0","1"
"2020-05-07","CORONEL RODOLFO S. DOMINGUEZ","0","2","0","2"
"2020-05-07","CORREA","0","5","0","5"
"2020-05-07","DESVIO ARIJON","0","1","0","1"
"2020-05-07","DIAZ","0","1","0","1"
"2020-05-07","DIEGO DE ALVEAR","0","1","0","1"
"2020-05-07","ELISA","0","0","1","1"
"2020-05-07","ELORTONDO","4","8","0","12"
"2020-05-07","EL RABON","0","1","0","1"
"2020-05-07","EL TREBOL","0","4","0","4"
"2020-05-07","EMPALME VILLA CONSTITUCION","0","4","0","4"
"2020-05-07","ESPERANZA","1","33","2","36"
"2020-05-07","FIGHIERA","0","3","0","3"
"2020-05-07","FIRMAT","1","15","0","16"
"2020-05-07","FLORENCIA","0","3","0","3"
"2020-05-07","FRANCK","1","9","0","10"
"2020-05-07","FRAY LUIS BELTRAN","4","27","0","31"
"2020-05-07","FRONTERA","0","20","1","21"
"2020-05-07","FUENTES","0","2","0","2"
"2020-05-07","FUNES","5","49","1","55"
"2020-05-07","GABOTO","0","3","1","4"
"2020-05-07","GALVEZ","9","19","0","28"
"2020-05-07","GENERAL LAGOS","0","4","0","4"
"2020-05-07","GESSLER","0","0","1","1"
"2020-05-07","GOBERNADOR CRESPO","0","2","0","2"
"2020-05-07","GODOY","0","1","0","1"
"2020-05-07","GRANADERO BAIGORRIA","2","81","1","84"
"2020-05-07","GREGORIA PEREZ DE DENIS","0","1","0","1"
"2020-05-07","HELVECIA","2","16","1","19"
"2020-05-07","HUGHES","0","5","0","5"
"2020-05-07","HUMBERTO PRIMO","0","1","0","1"
"2020-05-07","HUMBOLDT","1","1","0","2"
"2020-05-07","IBARLUCEA","0","8","0","8"
"2020-05-07","JOSEFINA","0","2","0","2"
"2020-05-07","JUAN B. MOLINA","0","1","0","1"
"2020-05-07","JUNCAL","0","2","0","2"
"2020-05-07","LA BRAVA","0","1","0","1"
"2020-05-07","LA CAROLINA","0","1","0","1"
"2020-05-07","LA CRIOLLA","0","2","1","3"
"2020-05-07","LAGUNA PAIVA","0","5","0","5"
"2020-05-07","LANDETA","0","1","0","1"
"2020-05-07","LANTERI","0","1","0","1"
"2020-05-07","LAS PAREJAS","1","8","0","9"
"2020-05-07","LAS ROSAS","1","9","1","11"
"2020-05-07","LAS TOSCAS","0","3","0","3"
"2020-05-07","LA VANGUARDIA","0","1","0","1"
"2020-05-07","LEHMANN","0","2","0","2"
"2020-05-07","LLAMBI CAMPBELL","3","3","0","6"
"2020-05-07","LOPEZ","0","2","0","2"
"2020-05-07","LOS MOLINOS","0","1","0","1"
"2020-05-07","LOS QUIRQUINCHOS","0","3","0","3"
"2020-05-07","LUIS PALACIOS","0","4","0","4"
"2020-05-07","MACIEL","0","4","1","5"
"2020-05-07","MAGGIOLO","0","3","0","3"
"2020-05-07","MALABRIGO","0","1","0","1"
"2020-05-07","MARGARITA","0","3","0","3"
"2020-05-07","MARIA JUANA","1","5","0","6"
"2020-05-07","MARIA SUSANA","0","3","0","3"
"2020-05-07","MARIA TERESA","0","2","0","2"
"2020-05-07","MAXIMO PAZ","0","2","0","2"
"2020-05-07","MELINCUE","0","1","0","1"
"2020-05-07","MIGUEL TORRES","0","3","0","3"
"2020-05-07","MONJE","0","2","0","2"
"2020-05-07","MONTEFIORE","0","1","0","1"
"2020-05-07","MONTES DE OCA","0","2","0","2"
"2020-05-07","MONTE VERA","0","8","0","8"
"2020-05-07","MURPHY","0","3","0","3"
"2020-05-07","NELSON","0","3","1","4"
"2020-05-07","NUEVO TORINO","0","1","0","1"
"2020-05-07","OLIVEROS","4","9","1","14"
"2020-05-07","PAVON","0","2","0","2"
"2020-05-07","PAVON ARRIBA","0","1","0","1"
"2020-05-07","PEREZ","0","48","1","49"
"2020-05-07","PIAMONTE","0","1","0","1"
"2020-05-07","PILAR","0","1","0","1"
"2020-05-07","PIÑERO","0","1","0","1"
"2020-05-07","PLAZA CLUCELLAS","0","4","0","4"
"2020-05-07","PRESIDENTE ROCA","0","1","0","1"
"2020-05-07","PUEBLO ANDINO","2","3","0","5"
"2020-05-07","PUEBLO ESTHER","0","17","1","18"
"2020-05-07","PUEBLO IRIGOYEN","0","1","0","1"
"2020-05-07","PUEBLO URANGA","0","1","0","1"
"2020-05-07","PUERTO GENERAL SAN MARTIN","0","20","0","20"
"2020-05-07","PUERTO RECONQUISTA","0","1","0","1"
"2020-05-07","PUJATO","2","7","0","9"
"2020-05-07","RAFAELA","21","110","11","142"
"2020-05-07","RAMONA","0","2","0","2"
"2020-05-07","RECONQUISTA","0","37","1","38"
"2020-05-07","RECREO","0","17","1","18"
"2020-05-07","RICARDONE","0","8","0","8"
"2020-05-07","RINCON POTRERO","0","1","0","1"
"2020-05-07","ROLDAN","6","36","0","42"
"2020-05-07","ROMANG","0","1","0","1"
"2020-05-07","ROSARIO","98","2747","57","2902"
"2020-05-07","RUFINO","0","20","0","20"
"2020-05-07","SALTO GRANDE","0","2","0","2"
"2020-05-07","SAN ANTONIO DE OBLIGADO","0","1","0","1"
"2020-05-07","SAN CARLOS CENTRO","0","9","0","9"
"2020-05-07","SAN CARLOS SUD","1","0","0","1"
"2020-05-07","SAN CRISTOBAL","0","3","0","3"
"2020-05-07","SANCTI SPIRITU","1","26","0","27"
"2020-05-07","SAN EDUARDO","0","6","0","6"
"2020-05-07","SANFORD","0","1","0","1"
"2020-05-07","SAN FRANCISCO DE SANTA FE","0","1","0","1"
"2020-05-07","SAN GENARO","1","4","0","5"
"2020-05-07","SAN GREGORIO","0","3","0","3"
"2020-05-07","SAN GUILLERMO","0","3","0","3"
"2020-05-07","SAN JAVIER","1","7","2","10"
"2020-05-07","SAN JERONIMO DEL SAUCE","0","1","0","1"
"2020-05-07","SAN JERONIMO NORTE","0","2","0","2"
"2020-05-07","SAN JERONIMO SUD","0","4","0","4"
"2020-05-07","SAN JORGE","0","9","0","9"
"2020-05-07","SAN JOSE DE LA ESQUINA","0","7","0","7"
"2020-05-07","SAN JOSE DEL RINCON","1","12","1","14"
"2020-05-07","SAN JUSTO","0","12","0","12"
"2020-05-07","SAN LORENZO","3","77","3","83"
"2020-05-07","SANTA CLARA DE BUENA VISTA","0","2","0","2"
"2020-05-07","SANTA FE","27","575","28","630"
"2020-05-07","SANTA ISABEL","0","6","1","7"
"2020-05-07","SANTA ROSA DE CALCHINES","0","3","0","3"
"2020-05-07","SANTO DOMINGO","0","1","0","1"
"2020-05-07","SANTO TOME","5","82","1","88"
"2020-05-07","SAN VICENTE","0","2","0","2"
"2020-05-07","SARGENTO CABRAL","0","1","0","1"
"2020-05-07","SARMIENTO","0","2","0","2"
"2020-05-07","SASTRE","0","3","0","3"
"2020-05-07","SAUCE VIEJO","1","18","0","19"
"2020-05-07","SERODINO","0","2","0","2"
"2020-05-07","SOLDINI","0","3","0","3"
"2020-05-07","SUARDI","0","4","0","4"
"2020-05-07","SUNCHALES","0","5","0","5"
"2020-05-07","SUSANA","0","1","0","1"
"2020-05-07","TACURAL","0","2","1","3"
"2020-05-07","TEODELINA","0","8","0","8"
"2020-05-07","TIMBUES","0","4","1","5"
"2020-05-07","TOSTADO","0","4","0","4"
"2020-05-07","TOTORAS","0","3","0","3"
"2020-05-07","VENADO TUERTO","12","175","5","192"
"2020-05-07","VERA","1","18","0","19"
"2020-05-07","VIDELA","0","1","0","1"
"2020-05-07","VILLA ANA","0","1","0","1"
"2020-05-07","VILLA CAÑAS","0","4","0","4"
"2020-05-07","VILLA CONSTITUCION","9","36","0","45"
"2020-05-07","VILLADA","0","1","0","1"
"2020-05-07","VILLA ELOISA","0","0","1","1"
"2020-05-07","VILLA GOBERNADOR GALVEZ","2","140","6","148"
"2020-05-07","VILLA MINETTI","0","3","0","3"
"2020-05-07","VILLA MUGUETA","0","4","0","4"
"2020-05-07","VILLA OCAMPO","0","1","0","1"
"2020-05-07","WHEELWRIGHT","0","5","1","6"
"2020-05-07","ZAVALLA","0","2","0","2"
"2020-05-08","ACEBAL","0","4","0","4"
"2020-05-08","ALBARELLOS","0","1","0","1"
"2020-05-08","ALCORTA","0","6","0","6"
"2020-05-08","ALVAREZ","0","5","0","5"
"2020-05-08","ALVEAR","0","8","1","9"
"2020-05-08","AMENABAR","0","1","0","1"
"2020-05-08","ANGEL GALLARDO","0","4","0","4"
"2020-05-08","AREQUITO","0","1","0","1"
"2020-05-08","ARMSTRONG","2","14","0","16"
"2020-05-08","AROCENA","0","5","0","5"
"2020-05-08","ARROYO AGUIAR","0","1","0","1"
"2020-05-08","ARROYO LEYES","0","8","0","8"
"2020-05-08","ARROYO SECO","2","27","0","29"
"2020-05-08","ARRUFO","0","2","0","2"
"2020-05-08","ARTEAGA","0","2","0","2"
"2020-05-08","AVELLANEDA","0","15","0","15"
"2020-05-08","BARRANCAS","0","3","0","3"
"2020-05-08","BERAVEBU","0","1","0","1"
"2020-05-08","BERNARDO DE IRIGOYEN","0","2","0","2"
"2020-05-08","BIGAND","0","12","1","13"
"2020-05-08","BOMBAL","0","4","0","4"
"2020-05-08","BOUQUET","0","1","0","1"
"2020-05-08","CAFFERATA","0","2","0","2"
"2020-05-08","CALCHAQUI","0","3","1","4"
"2020-05-08","CAÑADA DE GOMEZ","1","32","0","33"
"2020-05-08","CAÑADA DEL UCLE","0","1","0","1"
"2020-05-08","CAPITAN BERMUDEZ","1","47","1","49"
"2020-05-08","CARCARAÑA","0","11","0","11"
"2020-05-08","CARLOS PELLEGRINI","0","4","0","4"
"2020-05-08","CARMEN","0","1","0","1"
"2020-05-08","CARRERAS","0","3","0","3"
"2020-05-08","CARRIZALES","0","1","0","1"
"2020-05-08","CASILDA","2","42","2","46"
"2020-05-08","CAYASTA","1","4","0","5"
"2020-05-08","CERES","0","17","0","17"
"2020-05-08","CHABAS","1","4","0","5"
"2020-05-08","CHAÑAR LADEADO","0","1","0","1"
"2020-05-08","CHOVET","0","8","0","8"
"2020-05-08","CLASON","0","1","0","1"
"2020-05-08","COLONIA MASCIAS","0","1","0","1"
"2020-05-08","COLONIA ROSA","0","1","0","1"
"2020-05-08","CORONDA","0","10","0","10"
"2020-05-08","CORONEL ARNOLD","0","1","0","1"
"2020-05-08","CORONEL BOGADO","0","1","0","1"
"2020-05-08","CORONEL RODOLFO S. DOMINGUEZ","0","2","0","2"
"2020-05-08","CORREA","0","5","0","5"
"2020-05-08","DESVIO ARIJON","0","1","0","1"
"2020-05-08","DIAZ","0","1","0","1"
"2020-05-08","DIEGO DE ALVEAR","0","1","1","2"
"2020-05-08","ELISA","0","0","1","1"
"2020-05-08","ELORTONDO","4","8","0","12"
"2020-05-08","EL RABON","0","1","0","1"
"2020-05-08","EL TREBOL","0","4","0","4"
"2020-05-08","EMPALME VILLA CONSTITUCION","0","4","1","5"
"2020-05-08","ESPERANZA","1","35","2","38"
"2020-05-08","FIGHIERA","0","3","0","3"
"2020-05-08","FIRMAT","1","15","0","16"
"2020-05-08","FLORENCIA","0","3","0","3"
"2020-05-08","FRANCK","1","9","0","10"
"2020-05-08","FRAY LUIS BELTRAN","4","27","1","32"
"2020-05-08","FRONTERA","0","20","1","21"
"2020-05-08","FUENTES","0","2","0","2"
"2020-05-08","FUNES","5","51","1","57"
"2020-05-08","GABOTO","0","3","1","4"
"2020-05-08","GALVEZ","9","19","0","28"
"2020-05-08","GENERAL LAGOS","0","4","0","4"
"2020-05-08","GESSLER","0","0","1","1"
"2020-05-08","GOBERNADOR CRESPO","0","2","0","2"
"2020-05-08","GODOY","0","1","0","1"
"2020-05-08","GRANADERO BAIGORRIA","2","84","2","88"
"2020-05-08","GREGORIA PEREZ DE DENIS","0","1","0","1"
"2020-05-08","HELVECIA","2","16","1","19"
"2020-05-08","HUGHES","0","5","0","5"
"2020-05-08","HUMBERTO PRIMO","0","1","0","1"
"2020-05-08","HUMBOLDT","1","1","0","2"
"2020-05-08","IBARLUCEA","0","8","0","8"
"2020-05-08","JOSEFINA","0","2","0","2"
"2020-05-08","JUAN B. MOLINA","0","1","0","1"
"2020-05-08","JUNCAL","0","2","0","2"
"2020-05-08","LA BRAVA","0","1","0","1"
"2020-05-08","LA CAROLINA","0","1","0","1"
"2020-05-08","LA CRIOLLA","0","2","1","3"
"2020-05-08","LAGUNA PAIVA","0","5","0","5"
"2020-05-08","LANDETA","0","1","0","1"
"2020-05-08","LANTERI","0","1","0","1"
"2020-05-08","LAS PAREJAS","1","8","0","9"
"2020-05-08","LAS ROSAS","1","10","0","11"
"2020-05-08","LAS TOSCAS","0","3","0","3"
"2020-05-08","LA VANGUARDIA","0","1","0","1"
"2020-05-08","LEHMANN","0","2","0","2"
"2020-05-08","LLAMBI CAMPBELL","3","3","0","6"
"2020-05-08","LOPEZ","0","2","0","2"
"2020-05-08","LOS MOLINOS","0","1","0","1"
"2020-05-08","LOS QUIRQUINCHOS","0","3","0","3"
"2020-05-08","LUIS PALACIOS","0","4","0","4"
"2020-05-08","MACIEL","0","5","2","7"
"2020-05-08","MAGGIOLO","0","3","0","3"
"2020-05-08","MALABRIGO","0","1","0","1"
"2020-05-08","MARGARITA","0","3","0","3"
"2020-05-08","MARIA JUANA","1","5","0","6"
"2020-05-08","MARIA SUSANA","0","3","0","3"
"2020-05-08","MARIA TERESA","0","2","0","2"
"2020-05-08","MAXIMO PAZ","0","2","0","2"
"2020-05-08","MELINCUE","0","1","0","1"
"2020-05-08","MIGUEL TORRES","0","3","0","3"
"2020-05-08","MONJE","0","2","0","2"
"2020-05-08","MONTEFIORE","0","1","0","1"
"2020-05-08","MONTES DE OCA","0","2","0","2"
"2020-05-08","MONTE VERA","0","8","1","9"
"2020-05-08","MURPHY","0","3","0","3"
"2020-05-08","NELSON","0","4","0","4"
"2020-05-08","NUEVO TORINO","0","1","0","1"
"2020-05-08","OLIVEROS","4","9","1","14"
"2020-05-08","PAVON","0","2","0","2"
"2020-05-08","PAVON ARRIBA","0","1","0","1"
"2020-05-08","PEREZ","0","48","2","50"
"2020-05-08","PIAMONTE","0","1","0","1"
"2020-05-08","PILAR","0","1","0","1"
"2020-05-08","PIÑERO","0","1","0","1"
"2020-05-08","PLAZA CLUCELLAS","0","4","0","4"
"2020-05-08","PRESIDENTE ROCA","0","1","0","1"
"2020-05-08","PUEBLO ANDINO","2","3","0","5"
"2020-05-08","PUEBLO ESTHER","0","18","0","18"
"2020-05-08","PUEBLO IRIGOYEN","0","1","0","1"
"2020-05-08","PUEBLO URANGA","0","1","0","1"
"2020-05-08","PUERTO GENERAL SAN MARTIN","0","20","0","20"
"2020-05-08","PUERTO RECONQUISTA","0","1","0","1"
"2020-05-08","PUJATO","2","7","0","9"
"2020-05-08","RAFAELA","21","117","5","143"
"2020-05-08","RAMONA","0","2","0","2"
"2020-05-08","RECONQUISTA","0","37","1","38"
"2020-05-08","RECREO","0","18","0","18"
"2020-05-08","RICARDONE","0","8","0","8"
"2020-05-08","RINCON POTRERO","0","1","0","1"
"2020-05-08","ROLDAN","6","36","0","42"
"2020-05-08","ROMANG","0","1","0","1"
"2020-05-08","ROSARIO","98","2820","49","2967"
"2020-05-08","RUFINO","0","20","1","21"
"2020-05-08","SALTO GRANDE","0","2","0","2"
"2020-05-08","SAN ANTONIO DE OBLIGADO","0","1","0","1"
"2020-05-08","SAN CARLOS CENTRO","0","9","0","9"
"2020-05-08","SAN CARLOS SUD","1","0","0","1"
"2020-05-08","SAN CRISTOBAL","0","3","0","3"
"2020-05-08","SANCTI SPIRITU","1","26","0","27"
"2020-05-08","SAN EDUARDO","0","6","0","6"
"2020-05-08","SANFORD","0","1","0","1"
"2020-05-08","SAN FRANCISCO DE SANTA FE","0","1","0","1"
"2020-05-08","SAN GENARO","1","4","0","5"
"2020-05-08","SAN GREGORIO","0","3","0","3"
"2020-05-08","SAN GUILLERMO","0","3","0","3"
"2020-05-08","SAN JAVIER","1","8","1","10"
"2020-05-08","SAN JERONIMO DEL SAUCE","0","1","0","1"
"2020-05-08","SAN JERONIMO NORTE","0","2","0","2"
"2020-05-08","SAN JERONIMO SUD","0","4","0","4"
"2020-05-08","SAN JORGE","0","9","0","9"
"2020-05-08","SAN JOSE DE LA ESQUINA","0","7","0","7"
"2020-05-08","SAN JOSE DEL RINCON","1","12","1","14"
"2020-05-08","SAN JUSTO","0","12","0","12"
"2020-05-08","SAN LORENZO","3","77","4","84"
"2020-05-08","SANTA CLARA DE BUENA VISTA","0","2","0","2"
"2020-05-08","SANTA FE","27","583","27","637"
"2020-05-08","SANTA ISABEL","0","6","1","7"
"2020-05-08","SANTA ROSA DE CALCHINES","0","3","0","3"
"2020-05-08","SANTO DOMINGO","0","1","0","1"
"2020-05-08","SANTO TOME","5","84","0","89"
"2020-05-08","SAN VICENTE","0","2","0","2"
"2020-05-08","SARGENTO CABRAL","0","1","0","1"
"2020-05-08","SARMIENTO","0","2","0","2"
"2020-05-08","SASTRE","0","3","0","3"
"2020-05-08","SAUCE VIEJO","1","18","0","19"
"2020-05-08","SERODINO","0","2","0","2"
"2020-05-08","SOLDINI","0","3","0","3"
"2020-05-08","SUARDI","0","4","0","4"
"2020-05-08","SUNCHALES","0","5","0","5"
"2020-05-08","SUSANA","0","1","0","1"
"2020-05-08","TACURAL","0","3","0","3"
"2020-05-08","TEODELINA","0","8","0","8"
"2020-05-08","TIMBUES","0","4","2","6"
"2020-05-08","TOSTADO","0","4","0","4"
"2020-05-08","TOTORAS","0","3","0","3"
"2020-05-08","VENADO TUERTO","12","178","6","196"
"2020-05-08","VERA","1","18","0","19"
"2020-05-08","VIDELA","0","1","0","1"
"2020-05-08","VILLA ANA","0","1","0","1"
"2020-05-08","VILLA CAÑAS","0","4","0","4"
"2020-05-08","VILLA CONSTITUCION","9","36","0","45"
"2020-05-08","VILLADA","0","1","0","1"
"2020-05-08","VILLA ELOISA","0","1","0","1"
"2020-05-08","VILLA GOBERNADOR GALVEZ","2","143","6","151"
"2020-05-08","VILLA MINETTI","0","3","0","3"
"2020-05-08","VILLA MUGUETA","0","4","0","4"
"2020-05-08","VILLA OCAMPO","0","1","0","1"
"2020-05-08","WHEELWRIGHT","0","5","1","6"
"2020-05-08","ZAVALLA","0","2","0","2"
"2020-05-09","ACEBAL","0","4","0","4"
"2020-05-09","ALBARELLOS","0","1","0","1"
"2020-05-09","ALCORTA","0","6","0","6"
"2020-05-09","ALVAREZ","0","5","0","5"
"2020-05-09","ALVEAR","0","9","1","10"
"2020-05-09","AMENABAR","0","1","0","1"
"2020-05-09","ANGEL GALLARDO","0","4","0","4"
"2020-05-09","AREQUITO","0","2","0","2"
"2020-05-09","ARMSTRONG","2","14","1","17"
"2020-05-09","AROCENA","0","5","0","5"
"2020-05-09","ARROYO AGUIAR","0","1","0","1"
"2020-05-09","ARROYO LEYES","0","8","0","8"
"2020-05-09","ARROYO SECO","2","27","2","31"
"2020-05-09","ARRUFO","0","2","0","2"
"2020-05-09","ARTEAGA","0","2","0","2"
"2020-05-09","AVELLANEDA","0","15","0","15"
"2020-05-09","BARRANCAS","0","3","0","3"
"2020-05-09","BERAVEBU","0","1","0","1"
"2020-05-09","BERNARDO DE IRIGOYEN","0","2","0","2"
"2020-05-09","BIGAND","0","13","0","13"
"2020-05-09","BOMBAL","0","4","0","4"
"2020-05-09","BOUQUET","0","1","0","1"
"2020-05-09","CAFFERATA","0","2","0","2"
"2020-05-09","CALCHAQUI","0","4","0","4"
"2020-05-09","CAÑADA DE GOMEZ","1","33","1","35"
"2020-05-09","CAÑADA DEL UCLE","0","1","0","1"
"2020-05-09","CAPITAN BERMUDEZ","1","49","1","51"
"2020-05-09","CARCARAÑA","0","12","0","12"
"2020-05-09","CARLOS PELLEGRINI","0","4","0","4"
"2020-05-09","CARMEN","0","1","0","1"
"2020-05-09","CARRERAS","0","3","0","3"
"2020-05-09","CARRIZALES","0","1","0","1"
"2020-05-09","CASILDA","2","44","1","47"
"2020-05-09","CAYASTA","1","4","0","5"
"2020-05-09","CERES","0","17","0","17"
"2020-05-09","CHABAS","1","4","0","5"
"2020-05-09","CHAÑAR LADEADO","0","1","0","1"
"2020-05-09","CHOVET","0","8","0","8"
"2020-05-09","CLASON","0","1","0","1"
"2020-05-09","COLONIA MASCIAS","0","1","0","1"
"2020-05-09","COLONIA ROSA","0","1","0","1"
"2020-05-09","CORONDA","0","11","0","11"
"2020-05-09","CORONEL ARNOLD","0","1","0","1"
"2020-05-09","CORONEL BOGADO","0","2","0","2"
"2020-05-09","CORONEL RODOLFO S. DOMINGUEZ","0","2","0","2"
"2020-05-09","CORREA","0","6","0","6"
"2020-05-09","DESVIO ARIJON","0","1","0","1"
"2020-05-09","DIAZ","0","1","0","1"
"2020-05-09","DIEGO DE ALVEAR","0","2","0","2"
"2020-05-09","ELISA","0","1","0","1"
"2020-05-09","ELORTONDO","4","8","0","12"
"2020-05-09","EL RABON","0","1","0","1"
"2020-05-09","EL TREBOL","0","4","0","4"
"2020-05-09","EMPALME VILLA CONSTITUCION","0","6","0","6"
"2020-05-09","ESPERANZA","1","35","5","41"
"2020-05-09","FIGHIERA","0","3","0","3"
"2020-05-09","FIRMAT","1","17","2","20"
"2020-05-09","FLORENCIA","0","3","0","3"
"2020-05-09","FRANCK","1","9","0","10"
"2020-05-09","FRAY LUIS BELTRAN","4","28","1","33"
"2020-05-09","FRONTERA","0","20","1","21"
"2020-05-09","FUENTES","0","2","0","2"
"2020-05-09","FUNES","5","52","1","58"
"2020-05-09","GABOTO","0","3","1","4"
"2020-05-09","GALVEZ","9","19","0","28"
"2020-05-09","GENERAL LAGOS","0","4","0","4"
"2020-05-09","GESSLER","0","0","1","1"
"2020-05-09","GOBERNADOR CRESPO","0","2","0","2"
"2020-05-09","GODOY","0","1","0","1"
"2020-05-09","GRANADERO BAIGORRIA","2","86","2","90"
"2020-05-09","GREGORIA PEREZ DE DENIS","0","1","0","1"
"2020-05-09","HELVECIA","2","16","1","19"
"2020-05-09","HUGHES","0","6","0","6"
"2020-05-09","HUMBERTO PRIMO","0","1","0","1"
"2020-05-09","HUMBOLDT","1","1","0","2"
"2020-05-09","IBARLUCEA","0","8","0","8"
"2020-05-09","JOSEFINA","0","2","0","2"
"2020-05-09","JUAN B. MOLINA","0","1","0","1"
"2020-05-09","JUNCAL","0","2","0","2"
"2020-05-09","LA BRAVA","0","1","0","1"
"2020-05-09","LA CAROLINA","0","1","0","1"
"2020-05-09","LA CRIOLLA","0","2","1","3"
"2020-05-09","LAGUNA PAIVA","0","5","0","5"
"2020-05-09","LANDETA","0","1","0","1"
"2020-05-09","LANTERI","0","1","0","1"
"2020-05-09","LAS PAREJAS","1","8","0","9"
"2020-05-09","LAS ROSAS","1","11","0","12"
"2020-05-09","LAS TOSCAS","0","3","0","3"
"2020-05-09","LA VANGUARDIA","0","1","0","1"
"2020-05-09","LEHMANN","0","2","0","2"
"2020-05-09","LLAMBI CAMPBELL","3","3","0","6"
"2020-05-09","LOPEZ","0","2","0","2"
"2020-05-09","LOS MOLINOS","0","1","0","1"
"2020-05-09","LOS QUIRQUINCHOS","0","3","0","3"
"2020-05-09","LUIS PALACIOS","0","4","0","4"
"2020-05-09","MACIEL","0","5","2","7"
"2020-05-09","MAGGIOLO","0","4","0","4"
"2020-05-09","MALABRIGO","0","1","0","1"
"2020-05-09","MARGARITA","0","3","0","3"
"2020-05-09","MARIA JUANA","1","5","0","6"
"2020-05-09","MARIA SUSANA","0","3","0","3"
"2020-05-09","MARIA TERESA","0","2","0","2"
"2020-05-09","MAXIMO PAZ","0","2","0","2"
"2020-05-09","MELINCUE","0","1","0","1"
"2020-05-09","MIGUEL TORRES","0","3","0","3"
"2020-05-09","MONJE","0","2","0","2"
"2020-05-09","MONTEFIORE","0","1","0","1"
"2020-05-09","MONTES DE OCA","0","3","0","3"
"2020-05-09","MONTE VERA","0","8","1","9"
"2020-05-09","MURPHY","0","3","0","3"
"2020-05-09","NELSON","0","4","0","4"
"2020-05-09","NUEVO TORINO","0","1","0","1"
"2020-05-09","OLIVEROS","4","9","1","14"
"2020-05-09","PAVON","0","2","0","2"
"2020-05-09","PAVON ARRIBA","0","1","0","1"
"2020-05-09","PEREZ","0","50","1","51"
"2020-05-09","PIAMONTE","0","1","0","1"
"2020-05-09","PILAR","0","1","0","1"
"2020-05-09","PIÑERO","0","1","0","1"
"2020-05-09","PLAZA CLUCELLAS","0","4","0","4"
"2020-05-09","PRESIDENTE ROCA","0","1","0","1"
"2020-05-09","PUEBLO ANDINO","2","3","0","5"
"2020-05-09","PUEBLO ESTHER","0","19","0","19"
"2020-05-09","PUEBLO IRIGOYEN","0","1","0","1"
"2020-05-09","PUEBLO URANGA","0","1","0","1"
"2020-05-09","PUERTO GENERAL SAN MARTIN","0","23","0","23"
"2020-05-09","PUERTO RECONQUISTA","0","1","0","1"
"2020-05-09","PUJATO","2","7","0","9"
"2020-05-09","RAFAELA","21","117","5","143"
"2020-05-09","RAMONA","0","2","0","2"
"2020-05-09","RECONQUISTA","0","37","2","39"
"2020-05-09","RECREO","0","18","0","18"
"2020-05-09","RICARDONE","0","8","0","8"
"2020-05-09","RINCON POTRERO","0","1","0","1"
"2020-05-09","ROLDAN","6","38","0","44"
"2020-05-09","ROMANG","0","1","0","1"
"2020-05-09","ROSARIO","98","2898","40","3036"
"2020-05-09","RUFINO","0","21","0","21"
"2020-05-09","SALTO GRANDE","0","2","0","2"
"2020-05-09","SAN ANTONIO DE OBLIGADO","0","1","0","1"
"2020-05-09","SAN CARLOS CENTRO","0","10","0","10"
"2020-05-09","SAN CARLOS SUD","1","0","0","1"
"2020-05-09","SAN CRISTOBAL","0","3","0","3"
"2020-05-09","SANCTI SPIRITU","1","26","0","27"
"2020-05-09","SAN EDUARDO","0","6","0","6"
"2020-05-09","SANFORD","0","1","0","1"
"2020-05-09","SAN FRANCISCO DE SANTA FE","0","1","0","1"
"2020-05-09","SAN GENARO","1","4","0","5"
"2020-05-09","SAN GREGORIO","0","3","0","3"
"2020-05-09","SAN GUILLERMO","0","3","0","3"
"2020-05-09","SAN JAVIER","1","8","1","10"
"2020-05-09","SAN JERONIMO DEL SAUCE","0","1","0","1"
"2020-05-09","SAN JERONIMO NORTE","0","2","0","2"
"2020-05-09","SAN JERONIMO SUD","0","4","0","4"
"2020-05-09","SAN JORGE","0","9","0","9"
"2020-05-09","SAN JOSE DE LA ESQUINA","0","7","0","7"
"2020-05-09","SAN JOSE DEL RINCON","1","12","1","14"
"2020-05-09","SAN JUSTO","0","12","0","12"
"2020-05-09","SAN LORENZO","3","83","4","90"
"2020-05-09","SAN MARTIN NORTE","0","1","0","1"
"2020-05-09","SANTA CLARA DE BUENA VISTA","0","2","0","2"
"2020-05-09","SANTA FE","27","584","31","642"
"2020-05-09","SANTA ISABEL","0","6","1","7"
"2020-05-09","SANTA ROSA DE CALCHINES","0","3","1","4"
"2020-05-09","SANTO DOMINGO","0","1","0","1"
"2020-05-09","SANTO TOME","5","84","0","89"
"2020-05-09","SAN VICENTE","0","2","0","2"
"2020-05-09","SARGENTO CABRAL","0","1","0","1"
"2020-05-09","SARMIENTO","0","2","0","2"
"2020-05-09","SASTRE","0","3","0","3"
"2020-05-09","SAUCE VIEJO","1","18","0","19"
"2020-05-09","SERODINO","0","2","0","2"
"2020-05-09","SOLDINI","0","3","0","3"
"2020-05-09","SUARDI","0","4","0","4"
"2020-05-09","SUNCHALES","0","5","0","5"
"2020-05-09","SUSANA","0","1","0","1"
"2020-05-09","TACURAL","0","3","0","3"
"2020-05-09","TEODELINA","0","8","0","8"
"2020-05-09","TIMBUES","0","5","1","6"
"2020-05-09","TOSTADO","0","4","0","4"
"2020-05-09","TOTORAS","0","3","0","3"
"2020-05-09","VENADO TUERTO","12","178","6","196"
"2020-05-09","VERA","1","18","0","19"
"2020-05-09","VIDELA","0","1","0","1"
"2020-05-09","VILLA ANA","0","1","0","1"
"2020-05-09","VILLA CAÑAS","0","4","0","4"
"2020-05-09","VILLA CONSTITUCION","9","36","0","45"
"2020-05-09","VILLADA","0","1","0","1"
"2020-05-09","VILLA ELOISA","0","1","0","1"
"2020-05-09","VILLA GOBERNADOR GALVEZ","2","147","4","153"
"2020-05-09","VILLA MINETTI","0","3","0","3"
"2020-05-09","VILLA MUGUETA","0","4","0","4"
"2020-05-09","VILLA OCAMPO","0","1","0","1"
"2020-05-09","WHEELWRIGHT","0","5","1","6"
"2020-05-09","ZAVALLA","0","2","0","2"
"2020-05-10","ACEBAL","0","4","0","4"
"2020-05-10","ALBARELLOS","0","1","0","1"
"2020-05-10","ALCORTA","0","6","0","6"
"2020-05-10","ALVAREZ","0","5","0","5"
"2020-05-10","ALVEAR","0","10","0","10"
"2020-05-10","AMENABAR","0","1","0","1"
"2020-05-10","ANGEL GALLARDO","0","4","0","4"
"2020-05-10","AREQUITO","0","2","0","2"
"2020-05-10","ARMSTRONG","2","15","0","17"
"2020-05-10","AROCENA","0","5","0","5"
"2020-05-10","ARROYO AGUIAR","0","1","0","1"
"2020-05-10","ARROYO LEYES","0","8","0","8"
"2020-05-10","ARROYO SECO","2","29","0","31"
"2020-05-10","ARRUFO","0","2","0","2"
"2020-05-10","ARTEAGA","0","2","0","2"
"2020-05-10","AVELLANEDA","0","15","0","15"
"2020-05-10","BARRANCAS","0","3","0","3"
"2020-05-10","BERAVEBU","0","1","0","1"
"2020-05-10","BERNARDO DE IRIGOYEN","0","2","0","2"
"2020-05-10","BIGAND","0","13","0","13"
"2020-05-10","BOMBAL","0","4","0","4"
"2020-05-10","BOUQUET","0","1","0","1"
"2020-05-10","CAFFERATA","0","2","0","2"
"2020-05-10","CALCHAQUI","0","4","0","4"
"2020-05-10","CAÑADA DE GOMEZ","1","34","0","35"
"2020-05-10","CAÑADA DEL UCLE","0","1","0","1"
"2020-05-10","CAPITAN BERMUDEZ","1","50","0","51"
"2020-05-10","CARCARAÑA","0","12","0","12"
"2020-05-10","CARLOS PELLEGRINI","0","4","0","4"
"2020-05-10","CARMEN","0","1","0","1"
"2020-05-10","CARRERAS","0","3","0","3"
"2020-05-10","CARRIZALES","0","1","0","1"
"2020-05-10","CASILDA","2","44","1","47"
"2020-05-10","CAYASTA","1","4","0","5"
"2020-05-10","CERES","0","17","0","17"
"2020-05-10","CHABAS","1","4","0","5"
"2020-05-10","CHAÑAR LADEADO","0","1","0","1"
"2020-05-10","CHOVET","0","8","0","8"
"2020-05-10","CLASON","0","1","0","1"
"2020-05-10","COLONIA MASCIAS","0","1","0","1"
"2020-05-10","COLONIA ROSA","0","1","0","1"
"2020-05-10","CORONDA","0","11","0","11"
"2020-05-10","CORONEL ARNOLD","0","1","0","1"
"2020-05-10","CORONEL BOGADO","0","2","0","2"
"2020-05-10","CORONEL RODOLFO S. DOMINGUEZ","0","2","0","2"
"2020-05-10","CORREA","0","6","0","6"
"2020-05-10","DESVIO ARIJON","0","1","0","1"
"2020-05-10","DIAZ","0","1","0","1"
"2020-05-10","DIEGO DE ALVEAR","0","2","0","2"
"2020-05-10","ELISA","0","1","0","1"
"2020-05-10","ELORTONDO","4","8","0","12"
"2020-05-10","EL RABON","0","1","0","1"
"2020-05-10","EL TREBOL","0","4","0","4"
"2020-05-10","EMPALME VILLA CONSTITUCION","0","6","0","6"
"2020-05-10","ESPERANZA","1","35","5","41"
"2020-05-10","FIGHIERA","0","3","0","3"
"2020-05-10","FIRMAT","1","18","1","20"
"2020-05-10","FLORENCIA","0","3","0","3"
"2020-05-10","FRANCK","1","9","0","10"
"2020-05-10","FRAY LUIS BELTRAN","4","29","1","34"
"2020-05-10","FRONTERA","0","20","1","21"
"2020-05-10","FUENTES","0","2","0","2"
"2020-05-10","FUNES","5","52","1","58"
"2020-05-10","GABOTO","0","3","1","4"
"2020-05-10","GALVEZ","9","19","0","28"
"2020-05-10","GENERAL LAGOS","0","4","0","4"
"2020-05-10","GESSLER","0","0","1","1"
"2020-05-10","GOBERNADOR CRESPO","0","2","0","2"
"2020-05-10","GODEKEN","0","3","0","3"
"2020-05-10","GODOY","0","1","0","1"
"2020-05-10","GRANADERO BAIGORRIA","2","87","2","91"
"2020-05-10","GREGORIA PEREZ DE DENIS","0","1","0","1"
"2020-05-10","HELVECIA","2","16","1","19"
"2020-05-10","HUGHES","0","6","0","6"
"2020-05-10","HUMBERTO PRIMO","0","1","0","1"
"2020-05-10","HUMBOLDT","1","1","0","2"
"2020-05-10","IBARLUCEA","0","8","0","8"
"2020-05-10","JOSEFINA","0","2","0","2"
"2020-05-10","JUAN B. MOLINA","0","1","0","1"
"2020-05-10","JUNCAL","0","2","0","2"
"2020-05-10","LA BRAVA","0","1","0","1"
"2020-05-10","LA CAROLINA","0","1","0","1"
"2020-05-10","LA CRIOLLA","0","2","1","3"
"2020-05-10","LAGUNA PAIVA","0","5","0","5"
"2020-05-10","LANDETA","0","1","0","1"
"2020-05-10","LANTERI","0","1","0","1"
"2020-05-10","LAS PAREJAS","1","8","0","9"
"2020-05-10","LAS ROSAS","1","11","0","12"
"2020-05-10","LAS TOSCAS","0","3","0","3"
"2020-05-10","LA VANGUARDIA","0","1","0","1"
"2020-05-10","LEHMANN","0","2","0","2"
"2020-05-10","LLAMBI CAMPBELL","3","3","0","6"
"2020-05-10","LOPEZ","0","2","0","2"
"2020-05-10","LOS MOLINOS","0","1","0","1"
"2020-05-10","LOS QUIRQUINCHOS","0","3","0","3"
"2020-05-10","LUIS PALACIOS","0","4","0","4"
"2020-05-10","MACIEL","0","5","2","7"
"2020-05-10","MAGGIOLO","0","4","0","4"
"2020-05-10","MALABRIGO","0","1","0","1"
"2020-05-10","MARGARITA","0","3","0","3"
"2020-05-10","MARIA JUANA","1","5","0","6"
"2020-05-10","MARIA SUSANA","0","3","0","3"
"2020-05-10","MARIA TERESA","0","2","0","2"
"2020-05-10","MAXIMO PAZ","0","2","0","2"
"2020-05-10","MELINCUE","0","1","0","1"
"2020-05-10","MIGUEL TORRES","0","3","0","3"
"2020-05-10","MONJE","0","2","0","2"
"2020-05-10","MONTEFIORE","0","1","0","1"
"2020-05-10","MONTES DE OCA","0","3","0","3"
"2020-05-10","MONTE VERA","0","8","1","9"
"2020-05-10","MURPHY","0","3","0","3"
"2020-05-10","NELSON","0","4","0","4"
"2020-05-10","NUEVO TORINO","0","1","0","1"
"2020-05-10","OLIVEROS","4","9","1","14"
"2020-05-10","PAVON","0","2","0","2"
"2020-05-10","PAVON ARRIBA","0","1","0","1"
"2020-05-10","PEREZ","0","50","1","51"
"2020-05-10","PIAMONTE","0","1","0","1"
"2020-05-10","PILAR","0","1","0","1"
"2020-05-10","PIÑERO","0","1","0","1"
"2020-05-10","PLAZA CLUCELLAS","0","4","0","4"
"2020-05-10","PRESIDENTE ROCA","0","1","0","1"
"2020-05-10","PUEBLO ANDINO","2","3","0","5"
"2020-05-10","PUEBLO ESTHER","0","19","1","20"
"2020-05-10","PUEBLO IRIGOYEN","0","1","0","1"
"2020-05-10","PUEBLO URANGA","0","1","0","1"
"2020-05-10","PUERTO GENERAL SAN MARTIN","0","24","0","24"
"2020-05-10","PUERTO RECONQUISTA","0","1","0","1"
"2020-05-10","PUJATO","2","7","0","9"
"2020-05-10","RAFAELA","21","117","5","143"
"2020-05-10","RAMONA","0","2","0","2"
"2020-05-10","RECONQUISTA","0","37","2","39"
"2020-05-10","RECREO","0","18","0","18"
"2020-05-10","RICARDONE","0","8","0","8"
"2020-05-10","RINCON POTRERO","0","1","0","1"
"2020-05-10","ROLDAN","6","38","1","45"
"2020-05-10","ROMANG","0","1","0","1"
"2020-05-10","ROSARIO","98","2917","106","3121"
"2020-05-10","RUFINO","0","21","0","21"
"2020-05-10","SALTO GRANDE","0","2","0","2"
"2020-05-10","SAN ANTONIO DE OBLIGADO","0","1","0","1"
"2020-05-10","SAN CARLOS CENTRO","0","10","0","10"
"2020-05-10","SAN CARLOS SUD","1","0","0","1"
"2020-05-10","SAN CRISTOBAL","0","3","0","3"
"2020-05-10","SANCTI SPIRITU","1","26","0","27"
"2020-05-10","SAN EDUARDO","0","6","0","6"
"2020-05-10","SANFORD","0","1","0","1"
"2020-05-10","SAN FRANCISCO DE SANTA FE","0","1","0","1"
"2020-05-10","SAN GENARO","1","4","0","5"
"2020-05-10","SAN GREGORIO","0","3","0","3"
"2020-05-10","SAN GUILLERMO","0","3","0","3"
"2020-05-10","SAN JAVIER","1","8","1","10"
"2020-05-10","SAN JERONIMO DEL SAUCE","0","1","0","1"
"2020-05-10","SAN JERONIMO NORTE","0","2","0","2"
"2020-05-10","SAN JERONIMO SUD","0","4","0","4"
"2020-05-10","SAN JORGE","0","9","1","10"
"2020-05-10","SAN JOSE DE LA ESQUINA","0","7","0","7"
"2020-05-10","SAN JOSE DEL RINCON","1","12","1","14"
"2020-05-10","SAN JUSTO","0","12","0","12"
"2020-05-10","SAN LORENZO","3","84","3","90"
"2020-05-10","SAN MARTIN NORTE","0","1","0","1"
"2020-05-10","SANTA CLARA DE BUENA VISTA","0","2","0","2"
"2020-05-10","SANTA FE","27","585","30","642"
"2020-05-10","SANTA ISABEL","0","6","1","7"
"2020-05-10","SANTA ROSA DE CALCHINES","0","3","1","4"
"2020-05-10","SANTO DOMINGO","0","1","0","1"
"2020-05-10","SANTO TOME","5","84","1","90"
"2020-05-10","SAN VICENTE","0","2","0","2"
"2020-05-10","SARGENTO CABRAL","0","1","0","1"
"2020-05-10","SARMIENTO","0","2","0","2"
"2020-05-10","SASTRE","0","3","0","3"
"2020-05-10","SAUCE VIEJO","1","18","0","19"
"2020-05-10","SERODINO","0","2","0","2"
"2020-05-10","SOLDINI","0","3","1","4"
"2020-05-10","SUARDI","0","4","0","4"
"2020-05-10","SUNCHALES","0","5","0","5"
"2020-05-10","SUSANA","0","1","0","1"
"2020-05-10","TACURAL","0","3","0","3"
"2020-05-10","TEODELINA","0","8","0","8"
"2020-05-10","TIMBUES","0","5","1","6"
"2020-05-10","TOSTADO","0","4","0","4"
"2020-05-10","TOTORAS","0","4","0","4"
"2020-05-10","VENADO TUERTO","12","178","7","197"
"2020-05-10","VERA","1","19","0","20"
"2020-05-10","VIDELA","0","1","0","1"
"2020-05-10","VILLA ANA","0","1","0","1"
"2020-05-10","VILLA CAÑAS","0","4","0","4"
"2020-05-10","VILLA CONSTITUCION","9","36","1","46"
"2020-05-10","VILLADA","0","1","0","1"
"2020-05-10","VILLA ELOISA","0","1","0","1"
"2020-05-10","VILLA GOBERNADOR GALVEZ","2","148","10","160"
"2020-05-10","VILLA MINETTI","0","3","0","3"
"2020-05-10","VILLA MUGUETA","0","4","0","4"
"2020-05-10","VILLA OCAMPO","0","1","0","1"
"2020-05-10","WHEELWRIGHT","0","5","1","6"
"2020-05-10","ZAVALLA","0","2","0","2"
"2020-05-11","ACEBAL","0","4","0","4"
"2020-05-11","ALBARELLOS","0","1","0","1"
"2020-05-11","ALCORTA","0","6","0","6"
"2020-05-11","ALVAREZ","0","5","0","5"
"2020-05-11","ALVEAR","0","10","0","10"
"2020-05-11","AMENABAR","0","1","0","1"
"2020-05-11","ANGEL GALLARDO","0","4","0","4"
"2020-05-11","AREQUITO","0","2","0","2"
"2020-05-11","ARMSTRONG","2","15","0","17"
"2020-05-11","AROCENA","0","5","0","5"
"2020-05-11","ARROYO AGUIAR","0","1","0","1"
"2020-05-11","ARROYO LEYES","0","9","0","9"
"2020-05-11","ARROYO SECO","2","29","1","32"
"2020-05-11","ARRUFO","0","2","0","2"
"2020-05-11","ARTEAGA","0","2","0","2"
"2020-05-11","AVELLANEDA","0","15","0","15"
"2020-05-11","BARRANCAS","0","3","0","3"
"2020-05-11","BERAVEBU","0","1","0","1"
"2020-05-11","BERNARDO DE IRIGOYEN","0","2","0","2"
"2020-05-11","BIGAND","0","13","0","13"
"2020-05-11","BOMBAL","0","4","0","4"
"2020-05-11","BOUQUET","0","1","0","1"
"2020-05-11","BUSTINZA","0","0","1","1"
"2020-05-11","CAFFERATA","0","2","0","2"
"2020-05-11","CALCHAQUI","0","4","0","4"
"2020-05-11","CAÑADA DE GOMEZ","1","34","0","35"
"2020-05-11","CAÑADA DEL UCLE","0","1","0","1"
"2020-05-11","CAPITAN BERMUDEZ","1","51","0","52"
"2020-05-11","CARCARAÑA","0","14","0","14"
"2020-05-11","CARLOS PELLEGRINI","0","4","0","4"
"2020-05-11","CARMEN","0","1","0","1"
"2020-05-11","CARRERAS","0","3","0","3"
"2020-05-11","CARRIZALES","0","1","0","1"
"2020-05-11","CASILDA","2","44","1","47"
"2020-05-11","CAYASTA","1","4","0","5"
"2020-05-11","CERES","0","17","1","18"
"2020-05-11","CHABAS","1","4","0","5"
"2020-05-11","CHAÑAR LADEADO","0","2","0","2"
"2020-05-11","CHOVET","0","8","0","8"
"2020-05-11","CLASON","0","1","0","1"
"2020-05-11","COLONIA MASCIAS","0","1","0","1"
"2020-05-11","COLONIA ROSA","0","1","0","1"
"2020-05-11","CORONDA","0","11","0","11"
"2020-05-11","CORONEL ARNOLD","0","1","0","1"
"2020-05-11","CORONEL BOGADO","0","2","0","2"
"2020-05-11","CORONEL RODOLFO S. DOMINGUEZ","0","2","0","2"
"2020-05-11","CORREA","0","6","0","6"
"2020-05-11","DESVIO ARIJON","0","1","0","1"
"2020-05-11","DIAZ","0","1","0","1"
"2020-05-11","DIEGO DE ALVEAR","0","2","0","2"
"2020-05-11","ELISA","0","1","0","1"
"2020-05-11","ELORTONDO","4","8","0","12"
"2020-05-11","EL RABON","0","1","1","2"
"2020-05-11","EL TREBOL","0","4","0","4"
"2020-05-11","EMPALME VILLA CONSTITUCION","0","6","0","6"
"2020-05-11","ESPERANZA","1","35","7","43"
"2020-05-11","FIGHIERA","0","3","0","3"
"2020-05-11","FIRMAT","1","19","0","20"
"2020-05-11","FLORENCIA","0","3","0","3"
"2020-05-11","FRANCK","1","9","0","10"
"2020-05-11","FRAY LUIS BELTRAN","4","30","0","34"
"2020-05-11","FRONTERA","0","20","1","21"
"2020-05-11","FUENTES","0","2","0","2"
"2020-05-11","FUNES","5","53","1","59"
"2020-05-11","GABOTO","0","3","1","4"
"2020-05-11","GALVEZ","9","19","1","29"
"2020-05-11","GENERAL LAGOS","0","5","0","5"
"2020-05-11","GESSLER","0","0","1","1"
"2020-05-11","GOBERNADOR CRESPO","0","2","1","3"
"2020-05-11","GODEKEN","0","3","0","3"
"2020-05-11","GODOY","0","1","0","1"
"2020-05-11","GRANADERO BAIGORRIA","2","91","1","94"
"2020-05-11","GREGORIA PEREZ DE DENIS","0","1","0","1"
"2020-05-11","HELVECIA","2","16","1","19"
"2020-05-11","HUGHES","0","6","0","6"
"2020-05-11","HUMBERTO PRIMO","0","1","0","1"
"2020-05-11","HUMBOLDT","1","1","0","2"
"2020-05-11","IBARLUCEA","0","8","0","8"
"2020-05-11","JOSEFINA","0","2","0","2"
"2020-05-11","JUAN B. MOLINA","0","1","0","1"
"2020-05-11","JUNCAL","0","2","0","2"
"2020-05-11","LA BRAVA","0","1","0","1"
"2020-05-11","LA CAROLINA","0","1","0","1"
"2020-05-11","LA CRIOLLA","0","2","1","3"
"2020-05-11","LAGUNA PAIVA","0","5","0","5"
"2020-05-11","LANDETA","0","1","0","1"
"2020-05-11","LANTERI","0","1","0","1"
"2020-05-11","LAS PAREJAS","1","8","0","9"
"2020-05-11","LAS ROSAS","1","12","1","14"
"2020-05-11","LAS TOSCAS","0","3","0","3"
"2020-05-11","LA VANGUARDIA","0","1","0","1"
"2020-05-11","LEHMANN","0","2","0","2"
"2020-05-11","LLAMBI CAMPBELL","3","3","0","6"
"2020-05-11","LOPEZ","0","2","0","2"
"2020-05-11","LOS MOLINOS","0","1","0","1"
"2020-05-11","LOS QUIRQUINCHOS","0","3","0","3"
"2020-05-11","LUIS PALACIOS","0","4","0","4"
"2020-05-11","MACIEL","0","5","2","7"
"2020-05-11","MAGGIOLO","0","4","0","4"
"2020-05-11","MALABRIGO","0","1","0","1"
"2020-05-11","MARGARITA","0","3","0","3"
"2020-05-11","MARIA JUANA","1","5","2","8"
"2020-05-11","MARIA SUSANA","0","3","0","3"
"2020-05-11","MARIA TERESA","0","2","0","2"
"2020-05-11","MAXIMO PAZ","0","2","0","2"
"2020-05-11","MELINCUE","0","1","0","1"
"2020-05-11","MIGUEL TORRES","0","3","0","3"
"2020-05-11","MONJE","0","2","0","2"
"2020-05-11","MONTEFIORE","0","1","0","1"
"2020-05-11","MONTES DE OCA","0","3","0","3"
"2020-05-11","MONTE VERA","0","8","2","10"
"2020-05-11","MURPHY","0","3","0","3"
"2020-05-11","NELSON","0","4","0","4"
"2020-05-11","NUEVO TORINO","0","1","0","1"
"2020-05-11","OLIVEROS","4","9","1","14"
"2020-05-11","PAVON","0","2","0","2"
"2020-05-11","PAVON ARRIBA","0","1","0","1"
"2020-05-11","PEREZ","0","51","1","52"
"2020-05-11","PIAMONTE","0","1","0","1"
"2020-05-11","PILAR","0","1","0","1"
"2020-05-11","PIÑERO","0","1","0","1"
"2020-05-11","PLAZA CLUCELLAS","0","4","0","4"
"2020-05-11","PRESIDENTE ROCA","0","1","0","1"
"2020-05-11","PUEBLO ANDINO","2","3","0","5"
"2020-05-11","PUEBLO ESTHER","0","20","0","20"
"2020-05-11","PUEBLO IRIGOYEN","0","1","0","1"
"2020-05-11","PUEBLO URANGA","0","1","0","1"
"2020-05-11","PUERTO GENERAL SAN MARTIN","0","24","0","24"
"2020-05-11","PUERTO RECONQUISTA","0","1","0","1"
"2020-05-11","PUJATO","2","7","0","9"
"2020-05-11","RAFAELA","21","118","10","149"
"2020-05-11","RAMONA","0","2","0","2"
"2020-05-11","RECONQUISTA","0","38","3","41"
"2020-05-11","RECREO","0","18","1","19"
"2020-05-11","RICARDONE","0","8","0","8"
"2020-05-11","RINCON POTRERO","0","1","0","1"
"2020-05-11","ROLDAN","6","39","0","45"
"2020-05-11","ROMANG","0","1","0","1"
"2020-05-11","ROSARIO","98","3033","62","3193"
"2020-05-11","RUFINO","0","24","0","24"
"2020-05-11","SALTO GRANDE","0","2","0","2"
"2020-05-11","SAN ANTONIO DE OBLIGADO","0","1","0","1"
"2020-05-11","SAN CARLOS CENTRO","0","10","0","10"
"2020-05-11","SAN CARLOS SUD","1","0","0","1"
"2020-05-11","SAN CRISTOBAL","0","3","0","3"
"2020-05-11","SANCTI SPIRITU","1","26","0","27"
"2020-05-11","SAN EDUARDO","0","6","0","6"
"2020-05-11","SANFORD","0","1","0","1"
"2020-05-11","SAN FRANCISCO DE SANTA FE","0","1","0","1"
"2020-05-11","SAN GENARO","1","4","0","5"
"2020-05-11","SAN GREGORIO","0","4","0","4"
"2020-05-11","SAN GUILLERMO","0","3","0","3"
"2020-05-11","SAN JAVIER","1","8","1","10"
"2020-05-11","SAN JERONIMO DEL SAUCE","0","1","0","1"
"2020-05-11","SAN JERONIMO NORTE","0","2","0","2"
"2020-05-11","SAN JERONIMO SUD","0","4","0","4"
"2020-05-11","SAN JORGE","0","9","1","10"
"2020-05-11","SAN JOSE DE LA ESQUINA","0","8","0","8"
"2020-05-11","SAN JOSE DEL RINCON","1","12","1","14"
"2020-05-11","SAN JUSTO","0","12","1","13"
"2020-05-11","SAN LORENZO","3","87","3","93"
"2020-05-11","SAN MARTIN DE LAS ESCOBAS","0","2","0","2"
"2020-05-11","SAN MARTIN NORTE","0","1","0","1"
"2020-05-11","SANTA CLARA DE BUENA VISTA","0","2","0","2"
"2020-05-11","SANTA FE","27","586","45","658"
"2020-05-11","SANTA ISABEL","0","6","1","7"
"2020-05-11","SANTA ROSA DE CALCHINES","0","3","1","4"
"2020-05-11","SANTO DOMINGO","0","1","0","1"
"2020-05-11","SANTO TOME","5","85","1","91"
"2020-05-11","SAN VICENTE","0","3","0","3"
"2020-05-11","SARGENTO CABRAL","0","1","0","1"
"2020-05-11","SARMIENTO","0","2","0","2"
"2020-05-11","SASTRE","0","3","0","3"
"2020-05-11","SAUCE VIEJO","1","18","0","19"
"2020-05-11","SERODINO","0","2","0","2"
"2020-05-11","SOLDINI","0","5","0","5"
"2020-05-11","SUARDI","0","4","0","4"
"2020-05-11","SUNCHALES","0","5","0","5"
"2020-05-11","SUSANA","0","1","0","1"
"2020-05-11","TACURAL","0","3","0","3"
"2020-05-11","TEODELINA","0","8","0","8"
"2020-05-11","TIMBUES","0","5","1","6"
"2020-05-11","TOSTADO","0","4","1","5"
"2020-05-11","TOTORAS","0","4","0","4"
"2020-05-11","VENADO TUERTO","12","189","8","209"
"2020-05-11","VERA","1","19","0","20"
"2020-05-11","VIDELA","0","1","0","1"
"2020-05-11","VILLA ANA","0","1","1","2"
"2020-05-11","VILLA CAÑAS","0","4","0","4"
"2020-05-11","VILLA CONSTITUCION","9","37","1","47"
"2020-05-11","VILLADA","0","1","0","1"
"2020-05-11","VILLA ELOISA","0","1","0","1"
"2020-05-11","VILLA GOBERNADOR GALVEZ","2","156","4","162"
"2020-05-11","VILLA MINETTI","0","3","0","3"
"2020-05-11","VILLA MUGUETA","0","4","0","4"
"2020-05-11","VILLA OCAMPO","0","1","1","2"
"2020-05-11","VILLA TRINIDAD","0","1","0","1"
"2020-05-11","WHEELWRIGHT","0","5","1","6"
"2020-05-11","ZAVALLA","0","2","0","2"
"2020-05-12","ACEBAL","0","4","0","4"
"2020-05-12","ALBARELLOS","0","1","0","1"
"2020-05-12","ALCORTA","0","6","0","6"
"2020-05-12","ALVAREZ","0","5","1","6"
"2020-05-12","ALVEAR","0","10","0","10"
"2020-05-12","AMENABAR","0","1","0","1"
"2020-05-12","ANGEL GALLARDO","0","4","0","4"
"2020-05-12","AREQUITO","0","2","0","2"
"2020-05-12","ARMSTRONG","2","15","0","17"
"2020-05-12","AROCENA","0","5","0","5"
"2020-05-12","ARROYO AGUIAR","0","1","0","1"
"2020-05-12","ARROYO LEYES","0","9","0","9"
"2020-05-12","ARROYO SECO","2","30","1","33"
"2020-05-12","ARRUFO","0","2","0","2"
"2020-05-12","ARTEAGA","0","2","0","2"
"2020-05-12","AVELLANEDA","0","15","0","15"
"2020-05-12","BARRANCAS","0","3","0","3"
"2020-05-12","BERAVEBU","0","1","0","1"
"2020-05-12","BERNARDO DE IRIGOYEN","0","2","0","2"
"2020-05-12","BIGAND","0","13","0","13"
"2020-05-12","BOMBAL","0","5","0","5"
"2020-05-12","BOUQUET","0","1","0","1"
"2020-05-12","BUSTINZA","0","1","0","1"
"2020-05-12","CAFFERATA","0","2","0","2"
"2020-05-12","CALCHAQUI","0","4","0","4"
"2020-05-12","CAÑADA DE GOMEZ","1","38","0","39"
"2020-05-12","CAÑADA DEL UCLE","0","1","0","1"
"2020-05-12","CAPITAN BERMUDEZ","1","51","0","52"
"2020-05-12","CARCARAÑA","0","14","0","14"
"2020-05-12","CARLOS PELLEGRINI","0","4","0","4"
"2020-05-12","CARMEN","0","1","0","1"
"2020-05-12","CARRERAS","0","3","0","3"
"2020-05-12","CARRIZALES","0","1","0","1"
"2020-05-12","CASILDA","2","44","2","48"
"2020-05-12","CAYASTA","1","4","0","5"
"2020-05-12","CERES","0","17","1","18"
"2020-05-12","CHABAS","1","4","0","5"
"2020-05-12","CHAÑAR LADEADO","0","2","0","2"
"2020-05-12","CHOVET","0","8","0","8"
"2020-05-12","CLASON","0","1","0","1"
"2020-05-12","COLONIA MASCIAS","0","1","0","1"
"2020-05-12","COLONIA ROSA","0","1","0","1"
"2020-05-12","CORONDA","0","11","0","11"
"2020-05-12","CORONEL ARNOLD","0","1","0","1"
"2020-05-12","CORONEL BOGADO","0","2","0","2"
"2020-05-12","CORONEL RODOLFO S. DOMINGUEZ","0","2","0","2"
"2020-05-12","CORREA","0","6","0","6"
"2020-05-12","DESVIO ARIJON","0","1","0","1"
"2020-05-12","DIAZ","0","1","0","1"
"2020-05-12","DIEGO DE ALVEAR","0","2","0","2"
"2020-05-12","ELISA","0","1","0","1"
"2020-05-12","ELORTONDO","4","8","0","12"
"2020-05-12","EL RABON","0","2","0","2"
"2020-05-12","EL TREBOL","0","4","1","5"
"2020-05-12","EMPALME VILLA CONSTITUCION","0","6","0","6"
"2020-05-12","ESPERANZA","1","39","4","44"
"2020-05-12","FIGHIERA","0","3","0","3"
"2020-05-12","FIRMAT","1","19","0","20"
"2020-05-12","FLORENCIA","0","3","0","3"
"2020-05-12","FRANCK","1","9","0","10"
"2020-05-12","FRAY LUIS BELTRAN","4","30","0","34"
"2020-05-12","FRONTERA","0","21","1","22"
"2020-05-12","FUENTES","0","2","0","2"
"2020-05-12","FUNES","5","54","2","61"
"2020-05-12","GABOTO","0","3","1","4"
"2020-05-12","GALVEZ","9","20","0","29"
"2020-05-12","GENERAL LAGOS","0","5","0","5"
"2020-05-12","GESSLER","0","1","0","1"
"2020-05-12","GOBERNADOR CRESPO","0","2","1","3"
"2020-05-12","GODEKEN","0","3","0","3"
"2020-05-12","GODOY","0","1","0","1"
"2020-05-12","GRANADERO BAIGORRIA","2","93","2","97"
"2020-05-12","GREGORIA PEREZ DE DENIS","0","1","0","1"
"2020-05-12","HELVECIA","2","16","1","19"
"2020-05-12","HUGHES","0","6","0","6"
"2020-05-12","HUMBERTO PRIMO","0","1","0","1"
"2020-05-12","HUMBOLDT","1","1","0","2"
"2020-05-12","IBARLUCEA","0","8","0","8"
"2020-05-12","JOSEFINA","0","2","0","2"
"2020-05-12","JUAN B. MOLINA","0","1","0","1"
"2020-05-12","JUNCAL","0","2","0","2"
"2020-05-12","LA BRAVA","0","1","0","1"
"2020-05-12","LA CAROLINA","0","1","0","1"
"2020-05-12","LA CRIOLLA","0","3","0","3"
"2020-05-12","LAGUNA PAIVA","0","5","0","5"
"2020-05-12","LANDETA","0","1","0","1"
"2020-05-12","LANTERI","0","1","0","1"
"2020-05-12","LAS PAREJAS","1","8","2","11"
"2020-05-12","LAS ROSAS","1","14","0","15"
"2020-05-12","LAS TOSCAS","0","3","0","3"
"2020-05-12","LA VANGUARDIA","0","1","0","1"
"2020-05-12","LEHMANN","0","2","0","2"
"2020-05-12","LLAMBI CAMPBELL","3","3","0","6"
"2020-05-12","LOPEZ","0","2","0","2"
"2020-05-12","LOS MOLINOS","0","1","0","1"
"2020-05-12","LOS QUIRQUINCHOS","0","3","0","3"
"2020-05-12","LUIS PALACIOS","0","4","0","4"
"2020-05-12","MACIEL","0","6","1","7"
"2020-05-12","MAGGIOLO","0","4","0","4"
"2020-05-12","MALABRIGO","0","1","0","1"
"2020-05-12","MARGARITA","0","3","0","3"
"2020-05-12","MARIA JUANA","1","7","0","8"
"2020-05-12","MARIA SUSANA","0","3","0","3"
"2020-05-12","MARIA TERESA","0","2","0","2"
"2020-05-12","MAXIMO PAZ","0","2","0","2"
"2020-05-12","MELINCUE","0","1","0","1"
"2020-05-12","MIGUEL TORRES","0","3","0","3"
"2020-05-12","MONJE","0","2","0","2"
"2020-05-12","MONTEFIORE","0","1","0","1"
"2020-05-12","MONTES DE OCA","0","3","0","3"
"2020-05-12","MONTE VERA","0","9","1","10"
"2020-05-12","MURPHY","0","3","0","3"
"2020-05-12","NELSON","0","4","0","4"
"2020-05-12","NUEVO TORINO","0","1","0","1"
"2020-05-12","OLIVEROS","4","10","1","15"
"2020-05-12","PAVON","0","2","0","2"
"2020-05-12","PAVON ARRIBA","0","1","0","1"
"2020-05-12","PEREZ","0","51","1","52"
"2020-05-12","PIAMONTE","0","1","0","1"
"2020-05-12","PILAR","0","1","0","1"
"2020-05-12","PIÑERO","0","1","0","1"
"2020-05-12","PLAZA CLUCELLAS","0","4","0","4"
"2020-05-12","PRESIDENTE ROCA","0","1","0","1"
"2020-05-12","PUEBLO ANDINO","2","3","0","5"
"2020-05-12","PUEBLO ESTHER","0","20","2","22"
"2020-05-12","PUEBLO IRIGOYEN","0","1","0","1"
"2020-05-12","PUEBLO URANGA","0","1","0","1"
"2020-05-12","PUERTO GENERAL SAN MARTIN","0","24","0","24"
"2020-05-12","PUERTO RECONQUISTA","0","1","0","1"
"2020-05-12","PUJATO","2","7","0","9"
"2020-05-12","RAFAELA","21","124","7","152"
"2020-05-12","RAMONA","0","2","0","2"
"2020-05-12","RECONQUISTA","0","41","1","42"
"2020-05-12","RECREO","0","19","1","20"
"2020-05-12","RICARDONE","0","8","0","8"
"2020-05-12","RINCON POTRERO","0","1","0","1"
"2020-05-12","ROLDAN","6","40","0","46"
"2020-05-12","ROMANG","0","1","0","1"
"2020-05-12","ROSARIO","98","3111","54","3263"
"2020-05-12","RUFINO","0","24","0","24"
"2020-05-12","SALTO GRANDE","0","2","0","2"
"2020-05-12","SAN ANTONIO DE OBLIGADO","0","1","0","1"
"2020-05-12","SAN CARLOS CENTRO","0","10","0","10"
"2020-05-12","SAN CARLOS SUD","1","0","0","1"
"2020-05-12","SAN CRISTOBAL","0","3","0","3"
"2020-05-12","SANCTI SPIRITU","1","26","0","27"
"2020-05-12","SAN EDUARDO","0","6","0","6"
"2020-05-12","SANFORD","0","1","0","1"
"2020-05-12","SAN FRANCISCO DE SANTA FE","0","1","0","1"
"2020-05-12","SAN GENARO","1","4","0","5"
"2020-05-12","SAN GREGORIO","0","4","0","4"
"2020-05-12","SAN GUILLERMO","0","3","1","4"
"2020-05-12","SAN JAVIER","1","9","1","11"
"2020-05-12","SAN JERONIMO DEL SAUCE","0","1","0","1"
"2020-05-12","SAN JERONIMO NORTE","0","2","0","2"
"2020-05-12","SAN JERONIMO SUD","0","4","0","4"
"2020-05-12","SAN JORGE","0","10","1","11"
"2020-05-12","SAN JOSE DE LA ESQUINA","0","8","0","8"
"2020-05-12","SAN JOSE DEL RINCON","1","12","1","14"
"2020-05-12","SAN JUSTO","0","13","0","13"
"2020-05-12","SAN LORENZO","3","87","3","93"
"2020-05-12","SAN MARTIN DE LAS ESCOBAS","0","2","0","2"
"2020-05-12","SAN MARTIN NORTE","0","1","0","1"
"2020-05-12","SANTA CLARA DE BUENA VISTA","0","2","0","2"
"2020-05-12","SANTA FE","27","609","32","668"
"2020-05-12","SANTA ISABEL","0","8","1","9"
"2020-05-12","SANTA ROSA DE CALCHINES","0","4","0","4"
"2020-05-12","SANTO DOMINGO","0","1","0","1"
"2020-05-12","SANTO TOME","5","86","2","93"
"2020-05-12","SAN VICENTE","0","3","0","3"
"2020-05-12","SARGENTO CABRAL","0","1","0","1"
"2020-05-12","SARMIENTO","0","2","0","2"
"2020-05-12","SASTRE","0","3","0","3"
"2020-05-12","SAUCE VIEJO","1","18","2","21"
"2020-05-12","SERODINO","0","2","0","2"
"2020-05-12","SOLDINI","0","5","0","5"
"2020-05-12","SUARDI","0","4","0","4"
"2020-05-12","SUNCHALES","0","5","0","5"
"2020-05-12","SUSANA","0","1","0","1"
"2020-05-12","TACURAL","0","3","0","3"
"2020-05-12","TEODELINA","0","8","0","8"
"2020-05-12","TIMBUES","0","5","1","6"
"2020-05-12","TOSTADO","0","5","0","5"
"2020-05-12","TOTORAS","0","4","0","4"
"2020-05-12","VENADO TUERTO","12","194","5","211"
"2020-05-12","VERA","1","19","0","20"
"2020-05-12","VIDELA","0","1","0","1"
"2020-05-12","VILLA ANA","0","1","1","2"
"2020-05-12","VILLA CAÑAS","0","4","0","4"
"2020-05-12","VILLA CONSTITUCION","9","38","1","48"
"2020-05-12","VILLADA","0","1","0","1"
"2020-05-12","VILLA ELOISA","0","1","0","1"
"2020-05-12","VILLA GOBERNADOR GALVEZ","2","161","4","167"
"2020-05-12","VILLA MINETTI","0","3","0","3"
"2020-05-12","VILLA MUGUETA","0","5","0","5"
"2020-05-12","VILLA OCAMPO","0","1","1","2"
"2020-05-12","VILLA TRINIDAD","0","1","0","1"
"2020-05-12","WHEELWRIGHT","0","5","1","6"
"2020-05-12","ZAVALLA","0","4","0","4"
"2020-05-13","ACEBAL","0","4","0","4"
"2020-05-13","ALBARELLOS","0","1","0","1"
"2020-05-13","ALCORTA","0","6","0","6"
"2020-05-13","ALVAREZ","0","6","0","6"
"2020-05-13","ALVEAR","0","10","0","10"
"2020-05-13","AMENABAR","0","1","0","1"
"2020-05-13","ANGEL GALLARDO","0","4","0","4"
"2020-05-13","AREQUITO","0","2","0","2"
"2020-05-13","ARMSTRONG","2","15","0","17"
"2020-05-13","AROCENA","0","5","0","5"
"2020-05-13","ARROYO AGUIAR","0","1","0","1"
"2020-05-13","ARROYO LEYES","0","9","0","9"
"2020-05-13","ARROYO SECO","2","31","0","33"
"2020-05-13","ARRUFO","0","2","0","2"
"2020-05-13","ARTEAGA","0","2","0","2"
"2020-05-13","AVELLANEDA","0","15","0","15"
"2020-05-13","BARRANCAS","0","3","0","3"
"2020-05-13","BERAVEBU","0","1","0","1"
"2020-05-13","BERNARDO DE IRIGOYEN","0","2","0","2"
"2020-05-13","BIGAND","0","14","0","14"
"2020-05-13","BOMBAL","0","5","0","5"
"2020-05-13","BOUQUET","0","1","0","1"
"2020-05-13","BUSTINZA","0","1","0","1"
"2020-05-13","CAFFERATA","0","2","0","2"
"2020-05-13","CALCHAQUI","0","4","0","4"
"2020-05-13","CAÑADA DE GOMEZ","1","38","2","41"
"2020-05-13","CAÑADA DEL UCLE","0","1","0","1"
"2020-05-13","CAPITAN BERMUDEZ","1","51","2","54"
"2020-05-13","CARCARAÑA","0","14","0","14"
"2020-05-13","CARLOS PELLEGRINI","0","4","0","4"
"2020-05-13","CARMEN","0","1","0","1"
"2020-05-13","CARRERAS","0","3","0","3"
"2020-05-13","CARRIZALES","0","1","0","1"
"2020-05-13","CASILDA","2","45","4","51"
"2020-05-13","CAYASTA","1","4","0","5"
"2020-05-13","CERES","0","17","1","18"
"2020-05-13","CHABAS","1","4","1","6"
"2020-05-13","CHAÑAR LADEADO","0","2","0","2"
"2020-05-13","CHOVET","0","8","0","8"
"2020-05-13","CLASON","0","1","0","1"
"2020-05-13","COLONIA MASCIAS","0","1","0","1"
"2020-05-13","COLONIA ROSA","0","1","0","1"
"2020-05-13","CORONDA","0","11","0","11"
"2020-05-13","CORONEL ARNOLD","0","1","0","1"
"2020-05-13","CORONEL BOGADO","0","2","0","2"
"2020-05-13","CORONEL RODOLFO S. DOMINGUEZ","0","2","0","2"
"2020-05-13","CORREA","0","6","0","6"
"2020-05-13","CULULU","0","0","1","1"
"2020-05-13","DESVIO ARIJON","0","1","0","1"
"2020-05-13","DIAZ","0","1","0","1"
"2020-05-13","DIEGO DE ALVEAR","0","2","0","2"
"2020-05-13","ELISA","0","1","0","1"
"2020-05-13","ELORTONDO","4","8","0","12"
"2020-05-13","EL RABON","0","2","0","2"
"2020-05-13","EL TREBOL","0","5","2","7"
"2020-05-13","EMPALME VILLA CONSTITUCION","0","6","0","6"
"2020-05-13","ESPERANZA","1","39","4","44"
"2020-05-13","FIGHIERA","0","3","0","3"
"2020-05-13","FIRMAT","1","19","0","20"
"2020-05-13","FLORENCIA","0","3","0","3"
"2020-05-13","FRANCK","1","9","0","10"
"2020-05-13","FRAY LUIS BELTRAN","4","31","0","35"
"2020-05-13","FRONTERA","0","21","1","22"
"2020-05-13","FUENTES","0","2","0","2"
"2020-05-13","FUNES","5","57","2","64"
"2020-05-13","GABOTO","0","3","1","4"
"2020-05-13","GALVEZ","9","20","0","29"
"2020-05-13","GENERAL LAGOS","0","5","0","5"
"2020-05-13","GESSLER","0","1","0","1"
"2020-05-13","GOBERNADOR CRESPO","0","2","1","3"
"2020-05-13","GODEKEN","0","3","0","3"
"2020-05-13","GODOY","0","1","0","1"
"2020-05-13","GRANADERO BAIGORRIA","2","96","3","101"
"2020-05-13","GREGORIA PEREZ DE DENIS","0","1","0","1"
"2020-05-13","HELVECIA","2","16","2","20"
"2020-05-13","HUGHES","0","6","0","6"
"2020-05-13","HUMBERTO PRIMO","0","1","0","1"
"2020-05-13","HUMBOLDT","1","1","0","2"
"2020-05-13","IBARLUCEA","0","8","0","8"
"2020-05-13","JOSEFINA","0","2","0","2"
"2020-05-13","JUAN B. MOLINA","0","1","0","1"
"2020-05-13","JUNCAL","0","2","0","2"
"2020-05-13","LA BRAVA","0","1","0","1"
"2020-05-13","LA CAROLINA","0","1","0","1"
"2020-05-13","LA CRIOLLA","0","3","0","3"
"2020-05-13","LAGUNA PAIVA","0","5","0","5"
"2020-05-13","LANDETA","0","1","0","1"
"2020-05-13","LANTERI","0","1","0","1"
"2020-05-13","LAS PAREJAS","1","12","0","13"
"2020-05-13","LAS ROSAS","1","15","0","16"
"2020-05-13","LAS TOSCAS","0","3","0","3"
"2020-05-13","LA VANGUARDIA","0","1","0","1"
"2020-05-13","LEHMANN","0","2","0","2"
"2020-05-13","LLAMBI CAMPBELL","3","3","0","6"
"2020-05-13","LOPEZ","0","2","0","2"
"2020-05-13","LOS MOLINOS","0","1","0","1"
"2020-05-13","LOS QUIRQUINCHOS","0","3","0","3"
"2020-05-13","LUIS PALACIOS","0","4","0","4"
"2020-05-13","MACIEL","0","6","1","7"
"2020-05-13","MAGGIOLO","0","4","0","4"
"2020-05-13","MALABRIGO","0","1","0","1"
"2020-05-13","MARGARITA","0","3","0","3"
"2020-05-13","MARIA JUANA","1","7","0","8"
"2020-05-13","MARIA SUSANA","0","3","0","3"
"2020-05-13","MARIA TERESA","0","2","0","2"
"2020-05-13","MAXIMO PAZ","0","2","0","2"
"2020-05-13","MELINCUE","0","1","0","1"
"2020-05-13","MIGUEL TORRES","0","3","0","3"
"2020-05-13","MONJE","0","2","0","2"
"2020-05-13","MONTEFIORE","0","1","0","1"
"2020-05-13","MONTES DE OCA","0","3","0","3"
"2020-05-13","MONTE VERA","0","9","1","10"
"2020-05-13","MURPHY","0","3","0","3"
"2020-05-13","NELSON","0","4","0","4"
"2020-05-13","NUEVO TORINO","0","1","0","1"
"2020-05-13","OLIVEROS","4","10","1","15"
"2020-05-13","PAVON","0","2","0","2"
"2020-05-13","PAVON ARRIBA","0","1","0","1"
"2020-05-13","PEREZ","0","51","1","52"
"2020-05-13","PIAMONTE","0","1","0","1"
"2020-05-13","PILAR","0","1","0","1"
"2020-05-13","PIÑERO","0","1","0","1"
"2020-05-13","PLAZA CLUCELLAS","0","4","0","4"
"2020-05-13","PRESIDENTE ROCA","0","1","0","1"
"2020-05-13","PUEBLO ANDINO","2","3","0","5"
"2020-05-13","PUEBLO ESTHER","0","22","0","22"
"2020-05-13","PUEBLO IRIGOYEN","0","1","0","1"
"2020-05-13","PUEBLO URANGA","0","1","0","1"
"2020-05-13","PUERTO GENERAL SAN MARTIN","0","24","0","24"
"2020-05-13","PUERTO RECONQUISTA","0","1","0","1"
"2020-05-13","PUJATO","2","7","0","9"
"2020-05-13","RAFAELA","21","124","8","153"
"2020-05-13","RAMONA","0","2","0","2"
"2020-05-13","RECONQUISTA","0","41","1","42"
"2020-05-13","RECREO","0","19","1","20"
"2020-05-13","RICARDONE","0","8","0","8"
"2020-05-13","RINCON POTRERO","0","1","0","1"
"2020-05-13","ROLDAN","6","40","0","46"
"2020-05-13","ROMANG","0","1","0","1"
"2020-05-13","ROSARIO","98","3171","57","3326"
"2020-05-13","RUFINO","0","24","1","25"
"2020-05-13","SALTO GRANDE","0","2","0","2"
"2020-05-13","SAN ANTONIO DE OBLIGADO","0","1","0","1"
"2020-05-13","SAN CARLOS CENTRO","0","10","1","11"
"2020-05-13","SAN CARLOS SUD","1","0","0","1"
"2020-05-13","SAN CRISTOBAL","0","3","1","4"
"2020-05-13","SANCTI SPIRITU","1","26","0","27"
"2020-05-13","SAN EDUARDO","0","6","0","6"
"2020-05-13","SANFORD","0","1","0","1"
"2020-05-13","SAN FRANCISCO DE SANTA FE","0","1","0","1"
"2020-05-13","SAN GENARO","1","4","0","5"
"2020-05-13","SAN GREGORIO","0","4","0","4"
"2020-05-13","SAN GUILLERMO","0","3","1","4"
"2020-05-13","SAN JAVIER","1","9","1","11"
"2020-05-13","SAN JERONIMO DEL SAUCE","0","1","0","1"
"2020-05-13","SAN JERONIMO NORTE","0","2","0","2"
"2020-05-13","SAN JERONIMO SUD","0","4","0","4"
"2020-05-13","SAN JORGE","0","11","0","11"
"2020-05-13","SAN JOSE DE LA ESQUINA","0","8","0","8"
"2020-05-13","SAN JOSE DEL RINCON","1","12","1","14"
"2020-05-13","SAN JUSTO","0","13","0","13"
"2020-05-13","SAN LORENZO","3","88","6","97"
"2020-05-13","SAN MARTIN DE LAS ESCOBAS","0","2","0","2"
"2020-05-13","SAN MARTIN NORTE","0","1","0","1"
"2020-05-13","SANTA CLARA DE BUENA VISTA","0","2","0","2"
"2020-05-13","SANTA FE","27","610","38","675"
"2020-05-13","SANTA ISABEL","0","8","1","9"
"2020-05-13","SANTA ROSA DE CALCHINES","0","4","0","4"
"2020-05-13","SANTO DOMINGO","0","1","0","1"
"2020-05-13","SANTO TOME","5","86","5","96"
"2020-05-13","SAN VICENTE","0","3","0","3"
"2020-05-13","SARGENTO CABRAL","0","1","0","1"
"2020-05-13","SARMIENTO","0","2","0","2"
"2020-05-13","SASTRE","0","3","0","3"
"2020-05-13","SAUCE VIEJO","1","18","2","21"
"2020-05-13","SERODINO","0","2","0","2"
"2020-05-13","SOLDINI","0","5","0","5"
"2020-05-13","SUARDI","0","4","0","4"
"2020-05-13","SUNCHALES","0","5","0","5"
"2020-05-13","SUSANA","0","1","0","1"
"2020-05-13","TACURAL","0","3","0","3"
"2020-05-13","TEODELINA","0","8","0","8"
"2020-05-13","TIMBUES","0","5","1","6"
"2020-05-13","TOSTADO","0","5","0","5"
"2020-05-13","TOTORAS","0","4","0","4"
"2020-05-13","VENADO TUERTO","12","195","10","217"
"2020-05-13","VERA","1","19","0","20"
"2020-05-13","VIDELA","0","1","0","1"
"2020-05-13","VILLA ANA","0","1","1","2"
"2020-05-13","VILLA CAÑAS","0","4","0","4"
"2020-05-13","VILLA CONSTITUCION","9","39","0","48"
"2020-05-13","VILLADA","0","1","0","1"
"2020-05-13","VILLA ELOISA","0","1","0","1"
"2020-05-13","VILLA GOBERNADOR GALVEZ","2","163","6","171"
"2020-05-13","VILLA MINETTI","0","3","0","3"
"2020-05-13","VILLA MUGUETA","0","5","0","5"
"2020-05-13","VILLA OCAMPO","0","1","1","2"
"2020-05-13","VILLA TRINIDAD","0","1","0","1"
"2020-05-13","WHEELWRIGHT","0","5","1","6"
"2020-05-13","ZAVALLA","0","4","0","4"
"2020-05-14","ACEBAL","0","4","0","4"
"2020-05-14","ALBARELLOS","0","1","0","1"
"2020-05-14","ALCORTA","0","6","0","6"
"2020-05-14","ALVAREZ","0","6","0","6"
"2020-05-14","ALVEAR","0","10","0","10"
"2020-05-14","AMENABAR","0","1","0","1"
"2020-05-14","ANGEL GALLARDO","0","4","0","4"
"2020-05-14","AREQUITO","0","2","0","2"
"2020-05-14","ARMSTRONG","2","15","0","17"
"2020-05-14","AROCENA","0","5","0","5"
"2020-05-14","ARROYO AGUIAR","0","1","0","1"
"2020-05-14","ARROYO LEYES","0","9","0","9"
"2020-05-14","ARROYO SECO","2","31","0","33"
"2020-05-14","ARRUFO","0","2","0","2"
"2020-05-14","ARTEAGA","0","2","1","3"
"2020-05-14","AVELLANEDA","0","15","0","15"
"2020-05-14","BARRANCAS","0","3","0","3"
"2020-05-14","BERAVEBU","0","1","0","1"
"2020-05-14","BERNARDO DE IRIGOYEN","0","2","0","2"
"2020-05-14","BIGAND","0","14","0","14"
"2020-05-14","BOMBAL","0","5","0","5"
"2020-05-14","BOUQUET","0","1","0","1"
"2020-05-14","BUSTINZA","0","1","0","1"
"2020-05-14","CAFFERATA","0","2","0","2"
"2020-05-14","CALCHAQUI","0","4","0","4"
"2020-05-14","CAÑADA DE GOMEZ","1","41","0","42"
"2020-05-14","CAÑADA DEL UCLE","0","1","0","1"
"2020-05-14","CAPITAN BERMUDEZ","1","53","2","56"
"2020-05-14","CARCARAÑA","0","14","0","14"
"2020-05-14","CARLOS PELLEGRINI","0","4","0","4"
"2020-05-14","CARMEN","0","1","0","1"
"2020-05-14","CARRERAS","0","3","0","3"
"2020-05-14","CARRIZALES","0","1","0","1"
"2020-05-14","CASILDA","2","48","1","51"
"2020-05-14","CAYASTA","1","4","0","5"
"2020-05-14","CERES","0","18","0","18"
"2020-05-14","CHABAS","1","5","1","7"
"2020-05-14","CHAÑAR LADEADO","0","2","0","2"
"2020-05-14","CHOVET","0","8","0","8"
"2020-05-14","CLASON","0","1","0","1"
"2020-05-14","COLONIA MASCIAS","0","1","0","1"
"2020-05-14","COLONIA ROSA","0","1","0","1"
"2020-05-14","CORONDA","0","11","0","11"
"2020-05-14","CORONEL ARNOLD","0","1","0","1"
"2020-05-14","CORONEL BOGADO","0","2","0","2"
"2020-05-14","CORONEL RODOLFO S. DOMINGUEZ","0","2","0","2"
"2020-05-14","CORREA","0","6","0","6"
"2020-05-14","CULULU","0","0","1","1"
"2020-05-14","DESVIO ARIJON","0","1","0","1"
"2020-05-14","DIAZ","0","1","0","1"
"2020-05-14","DIEGO DE ALVEAR","0","2","0","2"
"2020-05-14","ELISA","0","1","0","1"
"2020-05-14","ELORTONDO","4","8","0","12"
"2020-05-14","EL RABON","0","2","0","2"
"2020-05-14","EL TREBOL","0","7","0","7"
"2020-05-14","EMPALME VILLA CONSTITUCION","0","6","0","6"
"2020-05-14","ESPERANZA","1","40","4","45"
"2020-05-14","FIGHIERA","0","3","0","3"
"2020-05-14","FIRMAT","1","20","0","21"
"2020-05-14","FLORENCIA","0","3","0","3"
"2020-05-14","FORTIN OLMOS","0","0","1","1"
"2020-05-14","FRANCK","1","9","0","10"
"2020-05-14","FRAY LUIS BELTRAN","4","32","0","36"
"2020-05-14","FRONTERA","0","21","3","24"
"2020-05-14","FUENTES","0","2","1","3"
"2020-05-14","FUNES","5","58","1","64"
"2020-05-14","GABOTO","0","3","1","4"
"2020-05-14","GALVEZ","9","20","0","29"
"2020-05-14","GENERAL LAGOS","0","5","0","5"
"2020-05-14","GESSLER","0","1","0","1"
"2020-05-14","GOBERNADOR CRESPO","0","3","0","3"
"2020-05-14","GODEKEN","0","3","0","3"
"2020-05-14","GODOY","0","1","0","1"
"2020-05-14","GRANADERO BAIGORRIA","2","101","4","107"
"2020-05-14","GREGORIA PEREZ DE DENIS","0","1","0","1"
"2020-05-14","HELVECIA","2","16","2","20"
"2020-05-14","HUGHES","0","6","0","6"
"2020-05-14","HUMBERTO PRIMO","0","1","0","1"
"2020-05-14","HUMBOLDT","1","1","0","2"
"2020-05-14","IBARLUCEA","0","8","0","8"
"2020-05-14","JOSEFINA","0","2","0","2"
"2020-05-14","JUAN B. MOLINA","0","1","0","1"
"2020-05-14","JUNCAL","0","2","0","2"
"2020-05-14","LA BRAVA","0","1","0","1"
"2020-05-14","LA CAROLINA","0","1","0","1"
"2020-05-14","LA CRIOLLA","0","3","0","3"
"2020-05-14","LAGUNA PAIVA","0","5","0","5"
"2020-05-14","LANDETA","0","1","0","1"
"2020-05-14","LANTERI","0","1","0","1"
"2020-05-14","LAS PAREJAS","1","12","1","14"
"2020-05-14","LAS ROSAS","1","15","0","16"
"2020-05-14","LAS TOSCAS","0","3","0","3"
"2020-05-14","LA VANGUARDIA","0","1","0","1"
"2020-05-14","LEHMANN","0","2","0","2"
"2020-05-14","LLAMBI CAMPBELL","3","3","0","6"
"2020-05-14","LOPEZ","0","2","0","2"
"2020-05-14","LOS MOLINOS","0","1","0","1"
"2020-05-14","LOS QUIRQUINCHOS","0","3","0","3"
"2020-05-14","LUIS PALACIOS","0","4","0","4"
"2020-05-14","MACIEL","0","6","1","7"
"2020-05-14","MAGGIOLO","0","4","0","4"
"2020-05-14","MALABRIGO","0","1","0","1"
"2020-05-14","MARGARITA","0","3","0","3"
"2020-05-14","MARIA JUANA","1","7","0","8"
"2020-05-14","MARIA SUSANA","0","3","0","3"
"2020-05-14","MARIA TERESA","0","2","0","2"
"2020-05-14","MAXIMO PAZ","0","2","0","2"
"2020-05-14","MELINCUE","0","1","0","1"
"2020-05-14","MIGUEL TORRES","0","3","0","3"
"2020-05-14","MONJE","0","2","0","2"
"2020-05-14","MONTEFIORE","0","1","0","1"
"2020-05-14","MONTES DE OCA","0","3","0","3"
"2020-05-14","MONTE VERA","0","9","1","10"
"2020-05-14","MURPHY","0","3","0","3"
"2020-05-14","NELSON","0","4","0","4"
"2020-05-14","NUEVO TORINO","0","1","0","1"
"2020-05-14","OLIVEROS","4","10","1","15"
"2020-05-14","PAVON","0","2","0","2"
"2020-05-14","PAVON ARRIBA","0","1","0","1"
"2020-05-14","PEREZ","0","53","1","54"
"2020-05-14","PIAMONTE","0","1","0","1"
"2020-05-14","PILAR","0","1","0","1"
"2020-05-14","PIÑERO","0","1","0","1"
"2020-05-14","PLAZA CLUCELLAS","0","4","0","4"
"2020-05-14","PRESIDENTE ROCA","0","1","0","1"
"2020-05-14","PUEBLO ANDINO","2","3","0","5"
"2020-05-14","PUEBLO ESTHER","0","22","0","22"
"2020-05-14","PUEBLO IRIGOYEN","0","1","0","1"
"2020-05-14","PUEBLO URANGA","0","1","0","1"
"2020-05-14","PUERTO GENERAL SAN MARTIN","0","24","0","24"
"2020-05-14","PUERTO RECONQUISTA","0","1","0","1"
"2020-05-14","PUJATO","2","7","0","9"
"2020-05-14","RAFAELA","21","127","6","154"
"2020-05-14","RAMONA","0","2","0","2"
"2020-05-14","RECONQUISTA","0","41","1","42"
"2020-05-14","RECREO","0","20","0","20"
"2020-05-14","RICARDONE","0","8","0","8"
"2020-05-14","RINCON POTRERO","0","1","0","1"
"2020-05-14","ROLDAN","6","40","0","46"
"2020-05-14","ROMANG","0","1","0","1"
"2020-05-14","ROSARIO","98","3253","79","3430"
"2020-05-14","RUFINO","0","25","0","25"
"2020-05-14","SALTO GRANDE","0","2","0","2"
"2020-05-14","SAN ANTONIO DE OBLIGADO","0","1","0","1"
"2020-05-14","SAN CARLOS CENTRO","0","11","0","11"
"2020-05-14","SAN CARLOS SUD","1","0","1","2"
"2020-05-14","SAN CRISTOBAL","0","3","1","4"
"2020-05-14","SANCTI SPIRITU","1","26","0","27"
"2020-05-14","SAN EDUARDO","0","7","0","7"
"2020-05-14","SANFORD","0","1","0","1"
"2020-05-14","SAN FRANCISCO DE SANTA FE","0","1","0","1"
"2020-05-14","SAN GENARO","1","4","0","5"
"2020-05-14","SAN GREGORIO","0","4","0","4"
"2020-05-14","SAN GUILLERMO","0","4","0","4"
"2020-05-14","SAN JAVIER","1","10","0","11"
"2020-05-14","SAN JERONIMO DEL SAUCE","0","1","0","1"
"2020-05-14","SAN JERONIMO NORTE","0","2","0","2"
"2020-05-14","SAN JERONIMO SUD","0","4","0","4"
"2020-05-14","SAN JORGE","0","11","0","11"
"2020-05-14","SAN JOSE DE LA ESQUINA","0","8","1","9"
"2020-05-14","SAN JOSE DEL RINCON","1","12","1","14"
"2020-05-14","SAN JUSTO","0","13","0","13"
"2020-05-14","SAN LORENZO","3","91","6","100"
"2020-05-14","SAN MARTIN DE LAS ESCOBAS","0","2","0","2"
"2020-05-14","SAN MARTIN NORTE","0","1","0","1"
"2020-05-14","SANTA CLARA DE BUENA VISTA","0","2","0","2"
"2020-05-14","SANTA FE","27","626","36","689"
"2020-05-14","SANTA ISABEL","0","8","1","9"
"2020-05-14","SANTA ROSA DE CALCHINES","0","4","0","4"
"2020-05-14","SANTO DOMINGO","0","1","0","1"
"2020-05-14","SANTO TOME","5","91","1","97"
"2020-05-14","SAN VICENTE","0","3","0","3"
"2020-05-14","SARGENTO CABRAL","0","1","0","1"
"2020-05-14","SARMIENTO","0","2","0","2"
"2020-05-14","SASTRE","0","3","0","3"
"2020-05-14","SAUCE VIEJO","1","20","0","21"
"2020-05-14","SERODINO","0","2","0","2"
"2020-05-14","SOLDINI","0","5","0","5"
"2020-05-14","SUARDI","0","4","0","4"
"2020-05-14","SUNCHALES","0","5","1","6"
"2020-05-14","SUSANA","0","1","0","1"
"2020-05-14","TACURAL","0","3","0","3"
"2020-05-14","TEODELINA","0","8","0","8"
"2020-05-14","TIMBUES","0","5","1","6"
"2020-05-14","TOSTADO","0","5","0","5"
"2020-05-14","TOTORAS","0","4","0","4"
"2020-05-14","VENADO TUERTO","12","200","7","219"
"2020-05-14","VERA","1","19","0","20"
"2020-05-14","VIDELA","0","1","0","1"
"2020-05-14","VILLA ANA","0","1","1","2"
"2020-05-14","VILLA CAÑAS","0","4","0","4"
"2020-05-14","VILLA CONSTITUCION","9","40","1","50"
"2020-05-14","VILLADA","0","1","0","1"
"2020-05-14","VILLA ELOISA","0","1","0","1"
"2020-05-14","VILLA GOBERNADOR GALVEZ","2","168","7","177"
"2020-05-14","VILLA MINETTI","0","3","1","4"
"2020-05-14","VILLA MUGUETA","0","5","0","5"
"2020-05-14","VILLA OCAMPO","0","2","1","3"
"2020-05-14","VILLA TRINIDAD","0","1","0","1"
"2020-05-14","WHEELWRIGHT","0","5","1","6"
"2020-05-14","ZAVALLA","0","4","0","4"
"2020-05-15","ACEBAL","0","4","1","5"
"2020-05-15","ALBARELLOS","0","1","0","1"
"2020-05-15","ALCORTA","0","6","0","6"
"2020-05-15","ALVAREZ","0","6","0","6"
"2020-05-15","ALVEAR","0","10","0","10"
"2020-05-15","AMENABAR","0","1","0","1"
"2020-05-15","ANGEL GALLARDO","0","4","0","4"
"2020-05-15","AREQUITO","0","2","0","2"
"2020-05-15","ARMSTRONG","2","15","1","18"
"2020-05-15","AROCENA","0","5","0","5"
"2020-05-15","ARROYO AGUIAR","0","1","0","1"
"2020-05-15","ARROYO LEYES","0","9","0","9"
"2020-05-15","ARROYO SECO","2","32","1","35"
"2020-05-15","ARRUFO","0","2","0","2"
"2020-05-15","ARTEAGA","0","3","0","3"
"2020-05-15","AVELLANEDA","0","15","0","15"
"2020-05-15","BARRANCAS","0","3","0","3"
"2020-05-15","BERAVEBU","0","1","0","1"
"2020-05-15","BERNARDO DE IRIGOYEN","0","2","0","2"
"2020-05-15","BIGAND","0","14","1","15"
"2020-05-15","BOMBAL","0","5","0","5"
"2020-05-15","BOUQUET","0","1","0","1"
"2020-05-15","BUSTINZA","0","1","0","1"
"2020-05-15","CAFFERATA","0","2","0","2"
"2020-05-15","CALCHAQUI","0","4","0","4"
"2020-05-15","CAÑADA DE GOMEZ","1","41","0","42"
"2020-05-15","CAÑADA DEL UCLE","0","1","0","1"
"2020-05-15","CAPITAN BERMUDEZ","1","54","2","57"
"2020-05-15","CARCARAÑA","0","14","0","14"
"2020-05-15","CARLOS PELLEGRINI","0","4","3","7"
"2020-05-15","CARMEN","0","1","0","1"
"2020-05-15","CARRERAS","0","3","0","3"
"2020-05-15","CARRIZALES","0","1","0","1"
"2020-05-15","CASILDA","2","48","1","51"
"2020-05-15","CAYASTA","1","4","0","5"
"2020-05-15","CERES","0","18","0","18"
"2020-05-15","CHABAS","1","6","1","8"
"2020-05-15","CHAÑAR LADEADO","0","2","0","2"
"2020-05-15","CHOVET","0","8","0","8"
"2020-05-15","CLASON","0","1","0","1"
"2020-05-15","COLONIA MASCIAS","0","1","0","1"
"2020-05-15","COLONIA ROSA","0","1","0","1"
"2020-05-15","CORONDA","0","11","0","11"
"2020-05-15","CORONEL ARNOLD","0","1","0","1"
"2020-05-15","CORONEL BOGADO","0","2","0","2"
"2020-05-15","CORONEL RODOLFO S. DOMINGUEZ","0","2","0","2"
"2020-05-15","CORREA","0","6","0","6"
"2020-05-15","CULULU","0","1","0","1"
"2020-05-15","DESVIO ARIJON","0","1","0","1"
"2020-05-15","DIAZ","0","1","0","1"
"2020-05-15","DIEGO DE ALVEAR","0","2","0","2"
"2020-05-15","ELISA","0","1","0","1"
"2020-05-15","ELORTONDO","4","8","0","12"
"2020-05-15","EL RABON","0","2","0","2"
"2020-05-15","EL TREBOL","0","7","0","7"
"2020-05-15","EMPALME VILLA CONSTITUCION","0","6","0","6"
"2020-05-15","ESPERANZA","1","40","6","47"
"2020-05-15","FIGHIERA","0","3","0","3"
"2020-05-15","FIRMAT","1","24","1","26"
"2020-05-15","FLORENCIA","0","3","0","3"
"2020-05-15","FORTIN OLMOS","0","0","1","1"
"2020-05-15","FRANCK","1","9","0","10"
"2020-05-15","FRAY LUIS BELTRAN","4","32","0","36"
"2020-05-15","FRONTERA","0","23","1","24"
"2020-05-15","FUENTES","0","3","0","3"
"2020-05-15","FUNES","5","59","1","65"
"2020-05-15","GABOTO","0","3","1","4"
"2020-05-15","GALVEZ","9","20","0","29"
"2020-05-15","GENERAL LAGOS","0","5","0","5"
"2020-05-15","GESSLER","0","1","0","1"
"2020-05-15","GOBERNADOR CRESPO","0","3","0","3"
"2020-05-15","GODEKEN","0","3","0","3"
"2020-05-15","GODOY","0","1","0","1"
"2020-05-15","GRANADERO BAIGORRIA","2","106","1","109"
"2020-05-15","GREGORIA PEREZ DE DENIS","0","1","0","1"
"2020-05-15","HELVECIA","2","16","2","20"
"2020-05-15","HUGHES","0","6","0","6"
"2020-05-15","HUMBERTO PRIMO","0","1","0","1"
"2020-05-15","HUMBOLDT","1","1","1","3"
"2020-05-15","IBARLUCEA","0","8","0","8"
"2020-05-15","JOSEFINA","0","2","0","2"
"2020-05-15","JUAN B. MOLINA","0","1","0","1"
"2020-05-15","JUNCAL","0","2","0","2"
"2020-05-15","LA BRAVA","0","1","0","1"
"2020-05-15","LA CAROLINA","0","1","0","1"
"2020-05-15","LA CRIOLLA","0","3","0","3"
"2020-05-15","LAGUNA PAIVA","0","5","1","6"
"2020-05-15","LANDETA","0","1","1","2"
"2020-05-15","LANTERI","0","1","0","1"
"2020-05-15","LAS PAREJAS","1","14","0","15"
"2020-05-15","LAS ROSAS","1","16","0","17"
"2020-05-15","LAS TOSCAS","0","3","0","3"
"2020-05-15","LA VANGUARDIA","0","1","0","1"
"2020-05-15","LEHMANN","0","2","0","2"
"2020-05-15","LLAMBI CAMPBELL","3","3","0","6"
"2020-05-15","LOPEZ","0","2","0","2"
"2020-05-15","LOS MOLINOS","0","1","0","1"
"2020-05-15","LOS QUIRQUINCHOS","0","3","0","3"
"2020-05-15","LUIS PALACIOS","0","4","0","4"
"2020-05-15","MACIEL","0","6","1","7"
"2020-05-15","MAGGIOLO","0","4","0","4"
"2020-05-15","MALABRIGO","0","1","0","1"
"2020-05-15","MARGARITA","0","3","0","3"
"2020-05-15","MARIA JUANA","1","7","0","8"
"2020-05-15","MARIA SUSANA","0","3","0","3"
"2020-05-15","MARIA TERESA","0","2","0","2"
"2020-05-15","MAXIMO PAZ","0","2","0","2"
"2020-05-15","MELINCUE","0","1","0","1"
"2020-05-15","MIGUEL TORRES","0","3","0","3"
"2020-05-15","MONJE","0","2","0","2"
"2020-05-15","MONTEFIORE","0","1","0","1"
"2020-05-15","MONTES DE OCA","0","3","0","3"
"2020-05-15","MONTE VERA","0","9","1","10"
"2020-05-15","MURPHY","0","3","0","3"
"2020-05-15","NELSON","0","4","0","4"
"2020-05-15","NUEVO TORINO","0","1","0","1"
"2020-05-15","OLIVEROS","4","10","1","15"
"2020-05-15","PAVON","0","2","0","2"
"2020-05-15","PAVON ARRIBA","0","1","0","1"
"2020-05-15","PEREZ","0","53","1","54"
"2020-05-15","PIAMONTE","0","1","0","1"
"2020-05-15","PILAR","0","1","0","1"
"2020-05-15","PIÑERO","0","1","0","1"
"2020-05-15","PLAZA CLUCELLAS","0","4","0","4"
"2020-05-15","PRESIDENTE ROCA","0","1","0","1"
"2020-05-15","PUEBLO ANDINO","2","3","0","5"
"2020-05-15","PUEBLO ESTHER","0","22","0","22"
"2020-05-15","PUEBLO IRIGOYEN","0","1","0","1"
"2020-05-15","PUEBLO URANGA","0","1","0","1"
"2020-05-15","PUERTO GENERAL SAN MARTIN","0","25","1","26"
"2020-05-15","PUERTO RECONQUISTA","0","1","0","1"
"2020-05-15","PUJATO","2","7","0","9"
"2020-05-15","RAFAELA","21","128","7","156"
"2020-05-15","RAMONA","0","2","0","2"
"2020-05-15","RECONQUISTA","0","41","1","42"
"2020-05-15","RECREO","0","20","0","20"
"2020-05-15","RICARDONE","0","8","0","8"
"2020-05-15","RINCON POTRERO","0","1","0","1"
"2020-05-15","ROLDAN","6","43","0","49"
"2020-05-15","ROMANG","0","1","0","1"
"2020-05-15","ROSARIO","98","3370","55","3523"
"2020-05-15","RUFINO","0","27","1","28"
"2020-05-15","SALTO GRANDE","0","2","0","2"
"2020-05-15","SAN ANTONIO DE OBLIGADO","0","1","0","1"
"2020-05-15","SAN CARLOS CENTRO","0","11","0","11"
"2020-05-15","SAN CARLOS SUD","1","1","0","2"
"2020-05-15","SAN CRISTOBAL","0","4","1","5"
"2020-05-15","SANCTI SPIRITU","1","26","0","27"
"2020-05-15","SAN EDUARDO","0","7","0","7"
"2020-05-15","SANFORD","0","1","0","1"
"2020-05-15","SAN FRANCISCO DE SANTA FE","0","1","0","1"
"2020-05-15","SAN GENARO","1","4","0","5"
"2020-05-15","SAN GREGORIO","0","4","0","4"
"2020-05-15","SAN GUILLERMO","0","4","0","4"
"2020-05-15","SAN JAVIER","1","10","0","11"
"2020-05-15","SAN JERONIMO DEL SAUCE","0","1","0","1"
"2020-05-15","SAN JERONIMO NORTE","0","2","0","2"
"2020-05-15","SAN JERONIMO SUD","0","4","0","4"
"2020-05-15","SAN JORGE","0","11","0","11"
"2020-05-15","SAN JOSE DE LA ESQUINA","0","10","2","12"
"2020-05-15","SAN JOSE DEL RINCON","1","12","1","14"
"2020-05-15","SAN JUSTO","0","13","1","14"
"2020-05-15","SAN LORENZO","3","94","4","101"
"2020-05-15","SAN MARTIN DE LAS ESCOBAS","0","2","0","2"
"2020-05-15","SAN MARTIN NORTE","0","1","0","1"
"2020-05-15","SANTA CLARA DE BUENA VISTA","0","2","0","2"
"2020-05-15","SANTA FE","27","634","40","701"
"2020-05-15","SANTA ISABEL","0","8","1","9"
"2020-05-15","SANTA ROSA DE CALCHINES","0","4","0","4"
"2020-05-15","SANTO DOMINGO","0","1","0","1"
"2020-05-15","SANTO TOME","5","91","4","100"
"2020-05-15","SAN VICENTE","0","3","0","3"
"2020-05-15","SARGENTO CABRAL","0","1","0","1"
"2020-05-15","SARMIENTO","0","2","0","2"
"2020-05-15","SASTRE","0","3","0","3"
"2020-05-15","SAUCE VIEJO","1","20","0","21"
"2020-05-15","SERODINO","0","2","0","2"
"2020-05-15","SOLDINI","0","5","0","5"
"2020-05-15","SUARDI","0","4","0","4"
"2020-05-15","SUNCHALES","0","5","2","7"
"2020-05-15","SUSANA","0","1","0","1"
"2020-05-15","TACURAL","0","3","0","3"
"2020-05-15","TEODELINA","0","8","0","8"
"2020-05-15","TIMBUES","0","5","1","6"
"2020-05-15","TOSTADO","0","5","0","5"
"2020-05-15","TOTORAS","0","4","0","4"
"2020-05-15","VENADO TUERTO","12","205","6","223"
"2020-05-15","VERA","1","19","0","20"
"2020-05-15","VIDELA","0","1","0","1"
"2020-05-15","VILLA ANA","0","1","1","2"
"2020-05-15","VILLA CAÑAS","0","4","0","4"
"2020-05-15","VILLA CONSTITUCION","9","41","1","51"
"2020-05-15","VILLADA","0","1","0","1"
"2020-05-15","VILLA ELOISA","0","1","0","1"
"2020-05-15","VILLA GOBERNADOR GALVEZ","2","170","6","178"
"2020-05-15","VILLA MINETTI","0","4","0","4"
"2020-05-15","VILLA MUGUETA","0","5","0","5"
"2020-05-15","VILLA OCAMPO","0","3","0","3"
"2020-05-15","VILLA TRINIDAD","0","1","0","1"
"2020-05-15","WHEELWRIGHT","0","5","2","7"
"2020-05-15","ZAVALLA","0","4","0","4"
"2020-05-16","ACEBAL","0","5","0","5"
"2020-05-16","ALBARELLOS","0","1","0","1"
"2020-05-16","ALCORTA","0","6","0","6"
"2020-05-16","ALVAREZ","0","6","0","6"
"2020-05-16","ALVEAR","0","10","0","10"
"2020-05-16","AMENABAR","0","1","0","1"
"2020-05-16","ANGEL GALLARDO","0","4","0","4"
"2020-05-16","AREQUITO","0","2","0","2"
"2020-05-16","ARMSTRONG","2","16","0","18"
"2020-05-16","AROCENA","0","5","0","5"
"2020-05-16","ARROYO AGUIAR","0","1","0","1"
"2020-05-16","ARROYO LEYES","0","9","0","9"
"2020-05-16","ARROYO SECO","2","33","0","35"
"2020-05-16","ARRUFO","0","2","0","2"
"2020-05-16","ARTEAGA","0","3","0","3"
"2020-05-16","AVELLANEDA","0","15","0","15"
"2020-05-16","BARRANCAS","0","3","0","3"
"2020-05-16","BERAVEBU","0","1","0","1"
"2020-05-16","BERNARDO DE IRIGOYEN","0","2","0","2"
"2020-05-16","BIGAND","0","15","0","15"
"2020-05-16","BOMBAL","0","5","0","5"
"2020-05-16","BOUQUET","0","1","0","1"
"2020-05-16","BUSTINZA","0","1","0","1"
"2020-05-16","CAFFERATA","0","2","0","2"
"2020-05-16","CALCHAQUI","0","4","0","4"
"2020-05-16","CAÑADA DE GOMEZ","1","41","1","43"
"2020-05-16","CAÑADA DEL UCLE","0","1","0","1"
"2020-05-16","CAPITAN BERMUDEZ","1","55","1","57"
"2020-05-16","CARCARAÑA","0","14","0","14"
"2020-05-16","CARLOS PELLEGRINI","0","7","0","7"
"2020-05-16","CARMEN","0","1","0","1"
"2020-05-16","CARRERAS","0","3","1","4"
"2020-05-16","CARRIZALES","0","1","0","1"
"2020-05-16","CASILDA","2","48","1","51"
"2020-05-16","CAYASTA","1","4","0","5"
"2020-05-16","CERES","0","18","0","18"
"2020-05-16","CHABAS","1","6","4","11"
"2020-05-16","CHAÑAR LADEADO","0","2","0","2"
"2020-05-16","CHOVET","0","8","0","8"
"2020-05-16","CLASON","0","1","0","1"
"2020-05-16","COLONIA MASCIAS","0","1","0","1"
"2020-05-16","COLONIA ROSA","0","1","0","1"
"2020-05-16","CORONDA","0","11","0","11"
"2020-05-16","CORONEL ARNOLD","0","1","0","1"
"2020-05-16","CORONEL BOGADO","0","2","0","2"
"2020-05-16","CORONEL RODOLFO S. DOMINGUEZ","0","2","0","2"
"2020-05-16","CORREA","0","6","0","6"
"2020-05-16","CULULU","0","1","0","1"
"2020-05-16","DESVIO ARIJON","0","1","1","2"
"2020-05-16","DIAZ","0","1","0","1"
"2020-05-16","DIEGO DE ALVEAR","0","2","0","2"
"2020-05-16","ELISA","0","1","0","1"
"2020-05-16","ELORTONDO","4","8","0","12"
"2020-05-16","EL RABON","0","2","0","2"
"2020-05-16","EL TREBOL","0","7","0","7"
"2020-05-16","EMPALME VILLA CONSTITUCION","0","6","0","6"
"2020-05-16","ESPERANZA","1","41","7","49"
"2020-05-16","FIGHIERA","0","3","0","3"
"2020-05-16","FIRMAT","1","25","0","26"
"2020-05-16","FLORENCIA","0","3","0","3"
"2020-05-16","FORTIN OLMOS","0","0","1","1"
"2020-05-16","FRANCK","1","9","0","10"
"2020-05-16","FRAY LUIS BELTRAN","4","32","0","36"
"2020-05-16","FRONTERA","0","23","2","25"
"2020-05-16","FUENTES","0","3","0","3"
"2020-05-16","FUNES","5","59","1","65"
"2020-05-16","GABOTO","0","3","1","4"
"2020-05-16","GALVEZ","9","20","0","29"
"2020-05-16","GENERAL LAGOS","0","5","0","5"
"2020-05-16","GESSLER","0","1","0","1"
"2020-05-16","GOBERNADOR CRESPO","0","3","0","3"
"2020-05-16","GODEKEN","0","3","0","3"
"2020-05-16","GODOY","0","1","0","1"
"2020-05-16","GRANADERO BAIGORRIA","2","108","1","111"
"2020-05-16","GREGORIA PEREZ DE DENIS","0","1","0","1"
"2020-05-16","HELVECIA","2","17","1","20"
"2020-05-16","HUGHES","0","6","0","6"
"2020-05-16","HUMBERTO PRIMO","0","1","0","1"
"2020-05-16","HUMBOLDT","1","2","0","3"
"2020-05-16","IBARLUCEA","0","9","0","9"
"2020-05-16","JOSEFINA","0","2","0","2"
"2020-05-16","JUAN B. MOLINA","0","1","0","1"
"2020-05-16","JUNCAL","0","2","0","2"
"2020-05-16","LA BRAVA","0","1","0","1"
"2020-05-16","LA CAROLINA","0","1","0","1"
"2020-05-16","LA CRIOLLA","0","3","0","3"
"2020-05-16","LAGUNA PAIVA","0","6","0","6"
"2020-05-16","LANDETA","0","2","0","2"
"2020-05-16","LANTERI","0","1","0","1"
"2020-05-16","LAS PAREJAS","1","14","0","15"
"2020-05-16","LAS ROSAS","1","16","0","17"
"2020-05-16","LAS TOSCAS","0","3","0","3"
"2020-05-16","LA VANGUARDIA","0","1","0","1"
"2020-05-16","LEHMANN","0","2","0","2"
"2020-05-16","LLAMBI CAMPBELL","3","3","0","6"
"2020-05-16","LOPEZ","0","2","0","2"
"2020-05-16","LOS MOLINOS","0","1","0","1"
"2020-05-16","LOS QUIRQUINCHOS","0","3","0","3"
"2020-05-16","LUIS PALACIOS","0","4","0","4"
"2020-05-16","MACIEL","0","6","1","7"
"2020-05-16","MAGGIOLO","0","4","0","4"
"2020-05-16","MALABRIGO","0","1","0","1"
"2020-05-16","MARGARITA","0","3","0","3"
"2020-05-16","MARIA JUANA","1","7","0","8"
"2020-05-16","MARIA SUSANA","0","4","0","4"
"2020-05-16","MARIA TERESA","0","2","0","2"
"2020-05-16","MAXIMO PAZ","0","2","0","2"
"2020-05-16","MELINCUE","0","1","0","1"
"2020-05-16","MIGUEL TORRES","0","3","0","3"
"2020-05-16","MONJE","0","2","0","2"
"2020-05-16","MONTEFIORE","0","1","0","1"
"2020-05-16","MONTES DE OCA","0","3","0","3"
"2020-05-16","MONTE VERA","0","9","1","10"
"2020-05-16","MURPHY","0","3","0","3"
"2020-05-16","NELSON","0","4","0","4"
"2020-05-16","NUEVO TORINO","0","1","0","1"
"2020-05-16","OLIVEROS","4","10","1","15"
"2020-05-16","PAVON","0","2","0","2"
"2020-05-16","PAVON ARRIBA","0","1","0","1"
"2020-05-16","PEREZ","0","53","1","54"
"2020-05-16","PIAMONTE","0","1","0","1"
"2020-05-16","PILAR","0","1","0","1"
"2020-05-16","PIÑERO","0","1","0","1"
"2020-05-16","PLAZA CLUCELLAS","0","4","0","4"
"2020-05-16","PRESIDENTE ROCA","0","1","0","1"
"2020-05-16","PUEBLO ANDINO","2","3","1","6"
"2020-05-16","PUEBLO ESTHER","0","22","0","22"
"2020-05-16","PUEBLO IRIGOYEN","0","1","0","1"
"2020-05-16","PUEBLO URANGA","0","1","0","1"
"2020-05-16","PUERTO GENERAL SAN MARTIN","0","26","0","26"
"2020-05-16","PUERTO RECONQUISTA","0","1","0","1"
"2020-05-16","PUJATO","2","7","0","9"
"2020-05-16","RAFAELA","21","131","4","156"
"2020-05-16","RAMONA","0","2","0","2"
"2020-05-16","RECONQUISTA","0","41","1","42"
"2020-05-16","RECREO","0","20","0","20"
"2020-05-16","RICARDONE","0","8","0","8"
"2020-05-16","RINCON POTRERO","0","1","0","1"
"2020-05-16","ROLDAN","6","44","0","50"
"2020-05-16","ROMANG","0","1","0","1"
"2020-05-16","ROSARIO","99","3437","93","3629"
"2020-05-16","RUFINO","0","28","0","28"
"2020-05-16","SALTO GRANDE","0","2","0","2"
"2020-05-16","SAN ANTONIO DE OBLIGADO","0","1","0","1"
"2020-05-16","SAN CARLOS CENTRO","0","11","0","11"
"2020-05-16","SAN CARLOS SUD","1","1","0","2"
"2020-05-16","SAN CRISTOBAL","0","5","0","5"
"2020-05-16","SANCTI SPIRITU","1","26","0","27"
"2020-05-16","SAN EDUARDO","0","7","0","7"
"2020-05-16","SANFORD","0","1","0","1"
"2020-05-16","SAN FRANCISCO DE SANTA FE","0","1","0","1"
"2020-05-16","SAN GENARO","1","4","0","5"
"2020-05-16","SAN GREGORIO","0","4","0","4"
"2020-05-16","SAN GUILLERMO","0","4","0","4"
"2020-05-16","SAN JAVIER","1","10","0","11"
"2020-05-16","SAN JERONIMO DEL SAUCE","0","1","0","1"
"2020-05-16","SAN JERONIMO NORTE","0","2","0","2"
"2020-05-16","SAN JERONIMO SUD","0","4","0","4"
"2020-05-16","SAN JORGE","0","11","0","11"
"2020-05-16","SAN JOSE DE LA ESQUINA","0","10","2","12"
"2020-05-16","SAN JOSE DEL RINCON","1","12","1","14"
"2020-05-16","SAN JUSTO","0","13","1","14"
"2020-05-16","SAN LORENZO","3","95","3","101"
"2020-05-16","SAN MARTIN DE LAS ESCOBAS","0","2","0","2"
"2020-05-16","SAN MARTIN NORTE","0","1","0","1"
"2020-05-16","SANTA CLARA DE BUENA VISTA","0","2","0","2"
"2020-05-16","SANTA FE","27","649","25","701"
"2020-05-16","SANTA ISABEL","0","8","1","9"
"2020-05-16","SANTA ROSA DE CALCHINES","0","4","0","4"
"2020-05-16","SANTO DOMINGO","0","1","0","1"
"2020-05-16","SANTO TOME","5","95","0","100"
"2020-05-16","SAN VICENTE","0","3","0","3"
"2020-05-16","SARGENTO CABRAL","0","1","0","1"
"2020-05-16","SARMIENTO","0","2","0","2"
"2020-05-16","SASTRE","0","3","0","3"
"2020-05-16","SAUCE VIEJO","1","20","0","21"
"2020-05-16","SERODINO","0","2","0","2"
"2020-05-16","SOLDINI","0","5","0","5"
"2020-05-16","SUARDI","0","4","0","4"
"2020-05-16","SUNCHALES","0","5","2","7"
"2020-05-16","SUSANA","0","1","0","1"
"2020-05-16","TACURAL","0","3","0","3"
"2020-05-16","TEODELINA","0","8","0","8"
"2020-05-16","TIMBUES","0","5","1","6"
"2020-05-16","TOSTADO","0","5","0","5"
"2020-05-16","TOTORAS","0","4","0","4"
"2020-05-16","VENADO TUERTO","12","206","5","223"
"2020-05-16","VERA","1","19","0","20"
"2020-05-16","VIDELA","0","1","0","1"
"2020-05-16","VILLA AMELIA","0","1","0","1"
"2020-05-16","VILLA ANA","0","1","1","2"
"2020-05-16","VILLA CAÑAS","0","4","0","4"
"2020-05-16","VILLA CONSTITUCION","9","43","0","52"
"2020-05-16","VILLADA","0","1","0","1"
"2020-05-16","VILLA ELOISA","0","1","0","1"
"2020-05-16","VILLA GOBERNADOR GALVEZ","2","174","7","183"
"2020-05-16","VILLA MINETTI","0","4","0","4"
"2020-05-16","VILLA MUGUETA","0","5","0","5"
"2020-05-16","VILLA OCAMPO","0","3","0","3"
"2020-05-16","VILLA TRINIDAD","0","1","0","1"
"2020-05-16","WHEELWRIGHT","0","6","1","7"
"2020-05-16","ZAVALLA","0","4","0","4"
"2020-05-17","ACEBAL","0","5","0","5"
"2020-05-17","ALBARELLOS","0","1","0","1"
"2020-05-17","ALCORTA","0","6","0","6"
"2020-05-17","ALVAREZ","0","6","0","6"
"2020-05-17","ALVEAR","0","10","0","10"
"2020-05-17","AMENABAR","0","1","0","1"
"2020-05-17","ANGEL GALLARDO","0","4","0","4"
"2020-05-17","AREQUITO","0","2","0","2"
"2020-05-17","ARMSTRONG","2","16","0","18"
"2020-05-17","AROCENA","0","5","0","5"
"2020-05-17","ARROYO AGUIAR","0","1","0","1"
"2020-05-17","ARROYO LEYES","0","9","0","9"
"2020-05-17","ARROYO SECO","2","33","0","35"
"2020-05-17","ARRUFO","0","2","0","2"
"2020-05-17","ARTEAGA","0","3","0","3"
"2020-05-17","AVELLANEDA","0","15","0","15"
"2020-05-17","BARRANCAS","0","3","0","3"
"2020-05-17","BERAVEBU","0","1","0","1"
"2020-05-17","BERNARDO DE IRIGOYEN","0","2","0","2"
"2020-05-17","BIGAND","0","15","0","15"
"2020-05-17","BOMBAL","0","5","0","5"
"2020-05-17","BOUQUET","0","1","0","1"
"2020-05-17","BUSTINZA","0","1","0","1"
"2020-05-17","CAFFERATA","0","2","0","2"
"2020-05-17","CALCHAQUI","0","4","0","4"
"2020-05-17","CAÑADA DE GOMEZ","1","41","1","43"
"2020-05-17","CAÑADA DEL UCLE","0","1","0","1"
"2020-05-17","CAPITAN BERMUDEZ","1","55","1","57"
"2020-05-17","CARCARAÑA","0","14","1","15"
"2020-05-17","CARLOS PELLEGRINI","0","7","0","7"
"2020-05-17","CARMEN","0","1","0","1"
"2020-05-17","CARRERAS","0","4","0","4"
"2020-05-17","CARRIZALES","0","1","0","1"
"2020-05-17","CASILDA","2","48","2","52"
"2020-05-17","CAYASTA","1","4","0","5"
"2020-05-17","CERES","0","18","0","18"
"2020-05-17","CHABAS","1","10","0","11"
"2020-05-17","CHAÑAR LADEADO","0","2","0","2"
"2020-05-17","CHOVET","0","8","1","9"
"2020-05-17","CLASON","0","1","0","1"
"2020-05-17","COLONIA MASCIAS","0","1","0","1"
"2020-05-17","COLONIA ROSA","0","1","0","1"
"2020-05-17","CORONDA","0","11","0","11"
"2020-05-17","CORONEL ARNOLD","0","1","0","1"
"2020-05-17","CORONEL BOGADO","0","2","0","2"
"2020-05-17","CORONEL RODOLFO S. DOMINGUEZ","0","2","0","2"
"2020-05-17","CORREA","0","6","0","6"
"2020-05-17","CULULU","0","1","0","1"
"2020-05-17","DESVIO ARIJON","0","1","1","2"
"2020-05-17","DIAZ","0","1","0","1"
"2020-05-17","DIEGO DE ALVEAR","0","2","0","2"
"2020-05-17","ELISA","0","1","0","1"
"2020-05-17","ELORTONDO","4","8","0","12"
"2020-05-17","EL RABON","0","2","0","2"
"2020-05-17","EL TREBOL","0","7","1","8"
"2020-05-17","EMPALME VILLA CONSTITUCION","0","6","0","6"
"2020-05-17","ESPERANZA","1","41","7","49"
"2020-05-17","FIGHIERA","0","3","1","4"
"2020-05-17","FIRMAT","1","25","0","26"
"2020-05-17","FLORENCIA","0","3","0","3"
"2020-05-17","FORTIN OLMOS","0","0","1","1"
"2020-05-17","FRANCK","1","9","0","10"
"2020-05-17","FRAY LUIS BELTRAN","4","32","0","36"
"2020-05-17","FRONTERA","0","25","0","25"
"2020-05-17","FUENTES","0","3","0","3"
"2020-05-17","FUNES","5","59","1","65"
"2020-05-17","GABOTO","0","3","1","4"
"2020-05-17","GALVEZ","9","20","0","29"
"2020-05-17","GENERAL LAGOS","0","5","0","5"
"2020-05-17","GESSLER","0","1","0","1"
"2020-05-17","GOBERNADOR CRESPO","0","3","0","3"
"2020-05-17","GODEKEN","0","3","0","3"
"2020-05-17","GODOY","0","1","0","1"
"2020-05-17","GRANADERO BAIGORRIA","2","109","0","111"
"2020-05-17","GREGORIA PEREZ DE DENIS","0","1","0","1"
"2020-05-17","HELVECIA","2","17","1","20"
"2020-05-17","HUGHES","0","6","1","7"
"2020-05-17","HUMBERTO PRIMO","0","1","0","1"
"2020-05-17","HUMBOLDT","1","2","0","3"
"2020-05-17","IBARLUCEA","0","9","0","9"
"2020-05-17","JOSEFINA","0","2","0","2"
"2020-05-17","JUAN B. MOLINA","0","1","0","1"
"2020-05-17","JUNCAL","0","2","0","2"
"2020-05-17","LA BRAVA","0","1","0","1"
"2020-05-17","LA CAROLINA","0","1","0","1"
"2020-05-17","LA CRIOLLA","0","3","0","3"
"2020-05-17","LAGUNA PAIVA","0","6","0","6"
"2020-05-17","LANDETA","0","2","0","2"
"2020-05-17","LANTERI","0","1","0","1"
"2020-05-17","LAS PAREJAS","1","14","1","16"
"2020-05-17","LAS ROSAS","1","16","0","17"
"2020-05-17","LAS TOSCAS","0","3","0","3"
"2020-05-17","LA VANGUARDIA","0","1","0","1"
"2020-05-17","LEHMANN","0","2","0","2"
"2020-05-17","LLAMBI CAMPBELL","3","3","0","6"
"2020-05-17","LOPEZ","0","2","0","2"
"2020-05-17","LOS MOLINOS","0","1","0","1"
"2020-05-17","LOS QUIRQUINCHOS","0","3","0","3"
"2020-05-17","LUIS PALACIOS","0","4","0","4"
"2020-05-17","MACIEL","0","6","1","7"
"2020-05-17","MAGGIOLO","0","4","0","4"
"2020-05-17","MALABRIGO","0","1","0","1"
"2020-05-17","MARGARITA","0","3","0","3"
"2020-05-17","MARIA JUANA","1","7","0","8"
"2020-05-17","MARIA SUSANA","0","4","0","4"
"2020-05-17","MARIA TERESA","0","2","0","2"
"2020-05-17","MAXIMO PAZ","0","2","0","2"
"2020-05-17","MELINCUE","0","1","0","1"
"2020-05-17","MIGUEL TORRES","0","3","0","3"
"2020-05-17","MONJE","0","2","0","2"
"2020-05-17","MONTEFIORE","0","1","0","1"
"2020-05-17","MONTES DE OCA","0","3","0","3"
"2020-05-17","MONTE VERA","0","9","1","10"
"2020-05-17","MURPHY","0","3","0","3"
"2020-05-17","NELSON","0","4","0","4"
"2020-05-17","NUEVO TORINO","0","1","0","1"
"2020-05-17","OLIVEROS","4","10","1","15"
"2020-05-17","PAVON","0","2","0","2"
"2020-05-17","PAVON ARRIBA","0","1","0","1"
"2020-05-17","PEREZ","0","53","1","54"
"2020-05-17","PIAMONTE","0","1","0","1"
"2020-05-17","PILAR","0","1","0","1"
"2020-05-17","PIÑERO","0","1","0","1"
"2020-05-17","PLAZA CLUCELLAS","0","4","0","4"
"2020-05-17","PRESIDENTE ROCA","0","1","0","1"
"2020-05-17","PUEBLO ANDINO","2","4","0","6"
"2020-05-17","PUEBLO ESTHER","0","22","0","22"
"2020-05-17","PUEBLO IRIGOYEN","0","1","0","1"
"2020-05-17","PUEBLO URANGA","0","1","0","1"
"2020-05-17","PUERTO GENERAL SAN MARTIN","0","26","2","28"
"2020-05-17","PUERTO RECONQUISTA","0","1","0","1"
"2020-05-17","PUJATO","2","7","0","9"
"2020-05-17","RAFAELA","21","131","10","162"
"2020-05-17","RAMONA","0","2","0","2"
"2020-05-17","RECONQUISTA","0","41","1","42"
"2020-05-17","RECREO","0","20","0","20"
"2020-05-17","RICARDONE","0","8","0","8"
"2020-05-17","RINCON POTRERO","0","1","0","1"
"2020-05-17","ROLDAN","6","44","1","51"
"2020-05-17","ROMANG","0","1","0","1"
"2020-05-17","ROSARIO","99","3466","126","3691"
"2020-05-17","RUFINO","0","28","1","29"
"2020-05-17","SALTO GRANDE","0","2","0","2"
"2020-05-17","SAN ANTONIO DE OBLIGADO","0","1","0","1"
"2020-05-17","SAN CARLOS CENTRO","0","11","0","11"
"2020-05-17","SAN CARLOS SUD","1","1","0","2"
"2020-05-17","SAN CRISTOBAL","0","5","0","5"
"2020-05-17","SANCTI SPIRITU","1","26","0","27"
"2020-05-17","SAN EDUARDO","0","7","0","7"
"2020-05-17","SANFORD","0","1","0","1"
"2020-05-17","SAN FRANCISCO DE SANTA FE","0","1","0","1"
"2020-05-17","SAN GENARO","1","4","0","5"
"2020-05-17","SAN GREGORIO","0","4","0","4"
"2020-05-17","SAN GUILLERMO","0","4","0","4"
"2020-05-17","SAN JAVIER","1","10","0","11"
"2020-05-17","SAN JERONIMO DEL SAUCE","0","1","0","1"
"2020-05-17","SAN JERONIMO NORTE","0","2","0","2"
"2020-05-17","SAN JERONIMO SUD","0","4","0","4"
"2020-05-17","SAN JORGE","0","11","0","11"
"2020-05-17","SAN JOSE DE LA ESQUINA","0","10","2","12"
"2020-05-17","SAN JOSE DEL RINCON","1","12","1","14"
"2020-05-17","SAN JUSTO","0","13","1","14"
"2020-05-17","SAN LORENZO","3","95","5","103"
"2020-05-17","SAN MARTIN DE LAS ESCOBAS","0","2","0","2"
"2020-05-17","SAN MARTIN NORTE","0","1","0","1"
"2020-05-17","SANTA CLARA DE BUENA VISTA","0","2","0","2"
"2020-05-17","SANTA FE","27","649","25","701"
"2020-05-17","SANTA ISABEL","0","8","1","9"
"2020-05-17","SANTA ROSA DE CALCHINES","0","4","0","4"
"2020-05-17","SANTO DOMINGO","0","1","0","1"
"2020-05-17","SANTO TOME","5","95","0","100"
"2020-05-17","SAN VICENTE","0","3","0","3"
"2020-05-17","SARGENTO CABRAL","0","1","0","1"
"2020-05-17","SARMIENTO","0","2","0","2"
"2020-05-17","SASTRE","0","3","0","3"
"2020-05-17","SAUCE VIEJO","1","20","0","21"
"2020-05-17","SERODINO","0","2","0","2"
"2020-05-17","SOLDINI","0","5","0","5"
"2020-05-17","SUARDI","0","4","0","4"
"2020-05-17","SUNCHALES","0","5","2","7"
"2020-05-17","SUSANA","0","1","0","1"
"2020-05-17","TACURAL","0","3","0","3"
"2020-05-17","TEODELINA","0","8","0","8"
"2020-05-17","TIMBUES","0","5","1","6"
"2020-05-17","TOSTADO","0","5","0","5"
"2020-05-17","TOTORAS","0","4","0","4"
"2020-05-17","VENADO TUERTO","12","206","6","224"
"2020-05-17","VERA","1","19","0","20"
"2020-05-17","VIDELA","0","1","0","1"
"2020-05-17","VILLA AMELIA","0","1","0","1"
"2020-05-17","VILLA ANA","0","1","1","2"
"2020-05-17","VILLA CAÑAS","0","4","0","4"
"2020-05-17","VILLA CONSTITUCION","9","43","0","52"
"2020-05-17","VILLADA","0","1","0","1"
"2020-05-17","VILLA ELOISA","0","1","0","1"
"2020-05-17","VILLA GOBERNADOR GALVEZ","2","176","12","190"
"2020-05-17","VILLA MINETTI","0","4","0","4"
"2020-05-17","VILLA MUGUETA","0","5","0","5"
"2020-05-17","VILLA OCAMPO","0","3","0","3"
"2020-05-17","VILLA TRINIDAD","0","1","0","1"
"2020-05-17","WHEELWRIGHT","0","6","1","7"
"2020-05-17","ZAVALLA","0","4","0","4"
"2020-05-18","ACEBAL","0","5","0","5"
"2020-05-18","ALBARELLOS","0","1","0","1"
"2020-05-18","ALCORTA","0","6","0","6"
"2020-05-18","ALDAO","0","1","0","1"
"2020-05-18","ALVAREZ","0","6","0","6"
"2020-05-18","ALVEAR","0","10","0","10"
"2020-05-18","AMENABAR","0","1","0","1"
"2020-05-18","ANGEL GALLARDO","0","4","0","4"
"2020-05-18","AREQUITO","0","2","0","2"
"2020-05-18","ARMSTRONG","2","16","0","18"
"2020-05-18","AROCENA","0","5","0","5"
"2020-05-18","ARROYO AGUIAR","0","1","0","1"
"2020-05-18","ARROYO LEYES","0","10","0","10"
"2020-05-18","ARROYO SECO","2","33","0","35"
"2020-05-18","ARRUFO","0","2","0","2"
"2020-05-18","ARTEAGA","0","3","0","3"
"2020-05-18","AVELLANEDA","0","15","0","15"
"2020-05-18","BARRANCAS","0","3","0","3"
"2020-05-18","BERAVEBU","0","1","0","1"
"2020-05-18","BERNARDO DE IRIGOYEN","0","2","0","2"
"2020-05-18","BIGAND","0","15","0","15"
"2020-05-18","BOMBAL","0","5","0","5"
"2020-05-18","BOUQUET","0","1","0","1"
"2020-05-18","BUSTINZA","0","1","0","1"
"2020-05-18","CAFFERATA","0","2","0","2"
"2020-05-18","CALCHAQUI","0","4","0","4"
"2020-05-18","CAÑADA DE GOMEZ","1","42","0","43"
"2020-05-18","CAÑADA DEL UCLE","0","1","0","1"
"2020-05-18","CAPITAN BERMUDEZ","1","57","1","59"
"2020-05-18","CARCARAÑA","0","15","0","15"
"2020-05-18","CARLOS PELLEGRINI","0","7","0","7"
"2020-05-18","CARMEN","0","1","0","1"
"2020-05-18","CARRERAS","0","4","0","4"
"2020-05-18","CARRIZALES","0","1","0","1"
"2020-05-18","CASILDA","2","50","2","54"
"2020-05-18","CAYASTA","1","4","0","5"
"2020-05-18","CERES","0","18","0","18"
"2020-05-18","CHABAS","1","10","0","11"
"2020-05-18","CHAÑAR LADEADO","0","2","0","2"
"2020-05-18","CHOVET","0","9","0","9"
"2020-05-18","CLASON","0","1","0","1"
"2020-05-18","COLONIA MASCIAS","0","1","0","1"
"2020-05-18","COLONIA ROSA","0","1","0","1"
"2020-05-18","CORONDA","0","11","0","11"
"2020-05-18","CORONEL ARNOLD","0","1","0","1"
"2020-05-18","CORONEL BOGADO","0","2","0","2"
"2020-05-18","CORONEL RODOLFO S. DOMINGUEZ","0","2","0","2"
"2020-05-18","CORREA","0","6","0","6"
"2020-05-18","CULULU","0","1","0","1"
"2020-05-18","DESVIO ARIJON","0","1","1","2"
"2020-05-18","DIAZ","0","1","0","1"
"2020-05-18","DIEGO DE ALVEAR","0","2","0","2"
"2020-05-18","ELISA","0","1","0","1"
"2020-05-18","ELORTONDO","4","8","0","12"
"2020-05-18","EL RABON","0","2","0","2"
"2020-05-18","EL TREBOL","0","8","0","8"
"2020-05-18","EMPALME VILLA CONSTITUCION","0","6","0","6"
"2020-05-18","ESPERANZA","1","44","6","51"
"2020-05-18","FIGHIERA","0","4","0","4"
"2020-05-18","FIRMAT","1","25","0","26"
"2020-05-18","FLORENCIA","0","3","0","3"
"2020-05-18","FORTIN OLMOS","0","1","1","2"
"2020-05-18","FRANCK","1","9","0","10"
"2020-05-18","FRAY LUIS BELTRAN","4","33","0","37"
"2020-05-18","FRONTERA","0","25","1","26"
"2020-05-18","FUENTES","0","3","0","3"
"2020-05-18","FUNES","5","59","1","65"
"2020-05-18","GABOTO","0","3","1","4"
"2020-05-18","GALVEZ","9","20","0","29"
"2020-05-18","GENERAL LAGOS","0","5","0","5"
"2020-05-18","GESSLER","0","1","0","1"
"2020-05-18","GOBERNADOR CRESPO","0","3","0","3"
"2020-05-18","GODEKEN","0","3","0","3"
"2020-05-18","GODOY","0","1","0","1"
"2020-05-18","GRANADERO BAIGORRIA","2","110","2","114"
"2020-05-18","GREGORIA PEREZ DE DENIS","0","1","0","1"
"2020-05-18","HELVECIA","2","17","3","22"
"2020-05-18","HUGHES","0","7","0","7"
"2020-05-18","HUMBERTO PRIMO","0","1","0","1"
"2020-05-18","HUMBOLDT","1","2","0","3"
"2020-05-18","IBARLUCEA","0","9","1","10"
"2020-05-18","JOSEFINA","0","2","0","2"
"2020-05-18","JUAN B. MOLINA","0","1","0","1"
"2020-05-18","JUNCAL","0","2","0","2"
"2020-05-18","LA BRAVA","0","1","0","1"
"2020-05-18","LA CAROLINA","0","1","0","1"
"2020-05-18","LA CRIOLLA","0","3","0","3"
"2020-05-18","LAGUNA PAIVA","0","7","0","7"
"2020-05-18","LANDETA","0","2","0","2"
"2020-05-18","LANTERI","0","1","0","1"
"2020-05-18","LAS PAREJAS","1","15","1","17"
"2020-05-18","LAS ROSAS","1","16","0","17"
"2020-05-18","LAS TOSCAS","0","3","0","3"
"2020-05-18","LA VANGUARDIA","0","1","0","1"
"2020-05-18","LEHMANN","0","2","0","2"
"2020-05-18","LLAMBI CAMPBELL","3","3","0","6"
"2020-05-18","LOPEZ","0","2","0","2"
"2020-05-18","LOS MOLINOS","0","1","0","1"
"2020-05-18","LOS QUIRQUINCHOS","0","3","0","3"
"2020-05-18","LUIS PALACIOS","0","4","0","4"
"2020-05-18","MACIEL","0","6","1","7"
"2020-05-18","MAGGIOLO","0","4","0","4"
"2020-05-18","MALABRIGO","0","1","0","1"
"2020-05-18","MARGARITA","0","3","0","3"
"2020-05-18","MARIA JUANA","1","7","0","8"
"2020-05-18","MARIA SUSANA","0","4","0","4"
"2020-05-18","MARIA TERESA","0","2","0","2"
"2020-05-18","MAXIMO PAZ","0","2","1","3"
"2020-05-18","MELINCUE","0","1","0","1"
"2020-05-18","MIGUEL TORRES","0","3","0","3"
"2020-05-18","MONJE","0","2","0","2"
"2020-05-18","MONTEFIORE","0","1","0","1"
"2020-05-18","MONTES DE OCA","0","3","0","3"
"2020-05-18","MONTE VERA","0","10","1","11"
"2020-05-18","MOUSSY","0","1","0","1"
"2020-05-18","MURPHY","0","3","0","3"
"2020-05-18","NELSON","0","4","0","4"
"2020-05-18","NUEVO TORINO","0","1","0","1"
"2020-05-18","OLIVEROS","4","10","1","15"
"2020-05-18","PAVON","0","2","0","2"
"2020-05-18","PAVON ARRIBA","0","1","0","1"
"2020-05-18","PEREZ","0","54","1","55"
"2020-05-18","PIAMONTE","0","1","0","1"
"2020-05-18","PILAR","0","1","0","1"
"2020-05-18","PIÑERO","0","1","0","1"
"2020-05-18","PLAZA CLUCELLAS","0","4","0","4"
"2020-05-18","PRESIDENTE ROCA","0","1","0","1"
"2020-05-18","PUEBLO ANDINO","2","4","0","6"
"2020-05-18","PUEBLO ESTHER","0","22","1","23"
"2020-05-18","PUEBLO IRIGOYEN","0","1","0","1"
"2020-05-18","PUEBLO URANGA","0","1","0","1"
"2020-05-18","PUERTO ARAGON","0","0","1","1"
"2020-05-18","PUERTO GENERAL SAN MARTIN","0","28","1","29"
"2020-05-18","PUERTO RECONQUISTA","0","1","0","1"
"2020-05-18","PUJATO","2","7","0","9"
"2020-05-18","RAFAELA","21","139","4","164"
"2020-05-18","RAMONA","0","2","0","2"
"2020-05-18","RECONQUISTA","0","42","5","47"
"2020-05-18","RECREO","0","21","0","21"
"2020-05-18","RICARDONE","0","8","0","8"
"2020-05-18","RINCON POTRERO","0","1","0","1"
"2020-05-18","ROLDAN","6","45","1","52"
"2020-05-18","ROMANG","0","1","0","1"
"2020-05-18","ROSARIO","103","3564","72","3739"
"2020-05-18","RUFINO","0","30","0","30"
"2020-05-18","SALTO GRANDE","0","2","0","2"
"2020-05-18","SAN ANTONIO DE OBLIGADO","0","1","0","1"
"2020-05-18","SAN CARLOS CENTRO","0","13","0","13"
"2020-05-18","SAN CARLOS SUD","1","1","0","2"
"2020-05-18","SAN CRISTOBAL","0","5","0","5"
"2020-05-18","SANCTI SPIRITU","1","26","0","27"
"2020-05-18","SAN EDUARDO","0","7","0","7"
"2020-05-18","SANFORD","0","1","1","2"
"2020-05-18","SAN FRANCISCO DE SANTA FE","0","1","0","1"
"2020-05-18","SAN GENARO","1","4","0","5"
"2020-05-18","SAN GREGORIO","0","4","0","4"
"2020-05-18","SAN GUILLERMO","0","4","0","4"
"2020-05-18","SAN JAVIER","1","10","1","12"
"2020-05-18","SAN JERONIMO DEL SAUCE","0","1","0","1"
"2020-05-18","SAN JERONIMO NORTE","0","2","0","2"
"2020-05-18","SAN JERONIMO SUD","0","4","0","4"
"2020-05-18","SAN JORGE","0","11","0","11"
"2020-05-18","SAN JOSE DE LA ESQUINA","0","10","2","12"
"2020-05-18","SAN JOSE DEL RINCON","1","12","1","14"
"2020-05-18","SAN JUSTO","0","14","1","15"
"2020-05-18","SAN LORENZO","3","97","4","104"
"2020-05-18","SAN MARTIN DE LAS ESCOBAS","0","2","0","2"
"2020-05-18","SAN MARTIN NORTE","0","1","0","1"
"2020-05-18","SANTA CLARA DE BUENA VISTA","0","2","0","2"
"2020-05-18","SANTA FE","27","666","30","723"
"2020-05-18","SANTA ISABEL","0","8","1","9"
"2020-05-18","SANTA ROSA DE CALCHINES","0","4","0","4"
"2020-05-18","SANTO DOMINGO","0","1","0","1"
"2020-05-18","SANTO TOME","5","96","2","103"
"2020-05-18","SAN VICENTE","0","3","0","3"
"2020-05-18","SA PEREYRA","0","1","0","1"
"2020-05-18","SARGENTO CABRAL","0","1","0","1"
"2020-05-18","SARMIENTO","0","2","0","2"
"2020-05-18","SASTRE","0","3","0","3"
"2020-05-18","SAUCE VIEJO","1","20","0","21"
"2020-05-18","SERODINO","0","2","0","2"
"2020-05-18","SOLDINI","0","5","0","5"
"2020-05-18","SUARDI","0","4","0","4"
"2020-05-18","SUNCHALES","0","7","0","7"
"2020-05-18","SUSANA","0","1","0","1"
"2020-05-18","TACURAL","0","3","0","3"
"2020-05-18","TEODELINA","0","8","0","8"
"2020-05-18","TIMBUES","0","5","1","6"
"2020-05-18","TOSTADO","0","5","0","5"
"2020-05-18","TOTORAS","0","6","0","6"
"2020-05-18","VENADO TUERTO","12","211","6","229"
"2020-05-18","VERA","1","20","0","21"
"2020-05-18","VIDELA","0","1","0","1"
"2020-05-18","VILLA AMELIA","0","1","0","1"
"2020-05-18","VILLA ANA","0","1","2","3"
"2020-05-18","VILLA CAÑAS","0","4","0","4"
"2020-05-18","VILLA CONSTITUCION","9","43","0","52"
"2020-05-18","VILLADA","0","1","0","1"
"2020-05-18","VILLA ELOISA","0","1","1","2"
"2020-05-18","VILLA GOBERNADOR GALVEZ","2","184","6","192"
"2020-05-18","VILLA MINETTI","0","4","0","4"
"2020-05-18","VILLA MUGUETA","0","5","0","5"
"2020-05-18","VILLA OCAMPO","0","3","2","5"
"2020-05-18","VILLA TRINIDAD","0","1","0","1"
"2020-05-18","WHEELWRIGHT","0","7","1","8"
"2020-05-18","ZAVALLA","0","4","0","4"
"2020-05-19","ACEBAL","0","5","0","5"
"2020-05-19","ALBARELLOS","0","1","0","1"
"2020-05-19","ALCORTA","0","6","0","6"
"2020-05-19","ALDAO","0","1","0","1"
"2020-05-19","ALVAREZ","0","6","0","6"
"2020-05-19","ALVEAR","0","10","0","10"
"2020-05-19","AMENABAR","0","1","0","1"
"2020-05-19","ANGEL GALLARDO","0","4","0","4"
"2020-05-19","AREQUITO","0","2","0","2"
"2020-05-19","ARMSTRONG","2","16","0","18"
"2020-05-19","AROCENA","0","5","0","5"
"2020-05-19","ARROYO AGUIAR","0","1","0","1"
"2020-05-19","ARROYO LEYES","0","10","1","11"
"2020-05-19","ARROYO SECO","2","33","0","35"
"2020-05-19","ARRUFO","0","2","0","2"
"2020-05-19","ARTEAGA","0","3","0","3"
"2020-05-19","AVELLANEDA","0","15","0","15"
"2020-05-19","BARRANCAS","0","3","0","3"
"2020-05-19","BERAVEBU","0","1","0","1"
"2020-05-19","BERNARDO DE IRIGOYEN","0","2","0","2"
"2020-05-19","BIGAND","0","15","0","15"
"2020-05-19","BOMBAL","0","5","0","5"
"2020-05-19","BOUQUET","0","1","0","1"
"2020-05-19","BUSTINZA","0","1","0","1"
"2020-05-19","CAFFERATA","0","2","0","2"
"2020-05-19","CALCHAQUI","0","5","1","6"
"2020-05-19","CAÑADA DE GOMEZ","1","43","0","44"
"2020-05-19","CAÑADA DEL UCLE","0","1","0","1"
"2020-05-19","CAPITAN BERMUDEZ","1","57","2","60"
"2020-05-19","CARCARAÑA","0","15","0","15"
"2020-05-19","CARLOS PELLEGRINI","0","7","0","7"
"2020-05-19","CARMEN","0","1","0","1"
"2020-05-19","CARRERAS","0","4","0","4"
"2020-05-19","CARRIZALES","0","1","1","2"
"2020-05-19","CASILDA","2","51","2","55"
"2020-05-19","CAYASTA","1","4","0","5"
"2020-05-19","CERES","0","18","1","19"
"2020-05-19","CHABAS","1","11","0","12"
"2020-05-19","CHAÑAR LADEADO","0","2","0","2"
"2020-05-19","CHOVET","0","9","0","9"
"2020-05-19","CLASON","0","1","0","1"
"2020-05-19","COLONIA MASCIAS","0","1","0","1"
"2020-05-19","COLONIA ROSA","0","1","0","1"
"2020-05-19","CORONDA","0","11","0","11"
"2020-05-19","CORONEL ARNOLD","0","1","0","1"
"2020-05-19","CORONEL BOGADO","0","2","0","2"
"2020-05-19","CORONEL RODOLFO S. DOMINGUEZ","0","2","0","2"
"2020-05-19","CORREA","0","6","1","7"
"2020-05-19","CULULU","0","1","0","1"
"2020-05-19","DESVIO ARIJON","0","2","0","2"
"2020-05-19","DIAZ","0","1","0","1"
"2020-05-19","DIEGO DE ALVEAR","0","2","0","2"
"2020-05-19","ELISA","0","1","0","1"
"2020-05-19","ELORTONDO","4","8","0","12"
"2020-05-19","EL RABON","0","2","0","2"
"2020-05-19","EL TREBOL","0","8","0","8"
"2020-05-19","EMPALME VILLA CONSTITUCION","0","6","0","6"
"2020-05-19","ESPERANZA","1","48","2","51"
"2020-05-19","FIGHIERA","0","4","0","4"
"2020-05-19","FIRMAT","1","25","0","26"
"2020-05-19","FLORENCIA","0","3","0","3"
"2020-05-19","FORTIN OLMOS","0","1","1","2"
"2020-05-19","FRANCK","1","9","0","10"
"2020-05-19","FRAY LUIS BELTRAN","4","33","0","37"
"2020-05-19","FRONTERA","0","26","0","26"
"2020-05-19","FUENTES","0","4","0","4"
"2020-05-19","FUNES","5","60","1","66"
"2020-05-19","GABOTO","0","3","1","4"
"2020-05-19","GALVEZ","9","20","0","29"
"2020-05-19","GENERAL LAGOS","0","5","0","5"
"2020-05-19","GESSLER","0","1","0","1"
"2020-05-19","GOBERNADOR CRESPO","0","3","0","3"
"2020-05-19","GODEKEN","0","4","0","4"
"2020-05-19","GODOY","0","1","0","1"
"2020-05-19","GRANADERO BAIGORRIA","2","112","2","116"
"2020-05-19","GREGORIA PEREZ DE DENIS","0","1","0","1"
"2020-05-19","HELVECIA","2","17","3","22"
"2020-05-19","HUGHES","0","7","0","7"
"2020-05-19","HUMBERTO PRIMO","0","1","0","1"
"2020-05-19","HUMBOLDT","1","2","0","3"
"2020-05-19","IBARLUCEA","0","10","0","10"
"2020-05-19","JOSEFINA","0","2","0","2"
"2020-05-19","JUAN B. MOLINA","0","1","0","1"
"2020-05-19","JUNCAL","0","2","0","2"
"2020-05-19","LA BRAVA","0","1","0","1"
"2020-05-19","LA CAROLINA","0","1","0","1"
"2020-05-19","LA CRIOLLA","0","3","0","3"
"2020-05-19","LAGUNA PAIVA","0","7","0","7"
"2020-05-19","LANDETA","0","2","0","2"
"2020-05-19","LANTERI","0","1","0","1"
"2020-05-19","LAS PAREJAS","1","17","0","18"
"2020-05-19","LAS ROSAS","1","18","0","19"
"2020-05-19","LAS TOSCAS","0","3","0","3"
"2020-05-19","LA VANGUARDIA","0","1","0","1"
"2020-05-19","LEHMANN","0","2","0","2"
"2020-05-19","LLAMBI CAMPBELL","3","3","0","6"
"2020-05-19","LOPEZ","0","2","0","2"
"2020-05-19","LOS MOLINOS","0","1","0","1"
"2020-05-19","LOS QUIRQUINCHOS","0","3","0","3"
"2020-05-19","LUIS PALACIOS","0","4","0","4"
"2020-05-19","MACIEL","0","6","1","7"
"2020-05-19","MAGGIOLO","0","4","0","4"
"2020-05-19","MALABRIGO","0","1","0","1"
"2020-05-19","MARGARITA","0","3","0","3"
"2020-05-19","MARIA JUANA","1","7","0","8"
"2020-05-19","MARIA SUSANA","0","4","0","4"
"2020-05-19","MARIA TERESA","0","2","0","2"
"2020-05-19","MAXIMO PAZ","0","3","0","3"
"2020-05-19","MELINCUE","0","1","0","1"
"2020-05-19","MIGUEL TORRES","0","3","0","3"
"2020-05-19","MONJE","0","2","0","2"
"2020-05-19","MONTEFIORE","0","1","0","1"
"2020-05-19","MONTES DE OCA","0","3","0","3"
"2020-05-19","MONTE VERA","0","11","0","11"
"2020-05-19","MOUSSY","0","1","0","1"
"2020-05-19","MURPHY","0","3","0","3"
"2020-05-19","NELSON","0","4","0","4"
"2020-05-19","NUEVO TORINO","0","1","0","1"
"2020-05-19","OLIVEROS","4","19","1","24"
"2020-05-19","PAVON","0","2","0","2"
"2020-05-19","PAVON ARRIBA","0","1","0","1"
"2020-05-19","PEREZ","0","54","2","56"
"2020-05-19","PIAMONTE","0","1","0","1"
"2020-05-19","PILAR","0","1","3","4"
"2020-05-19","PIÑERO","0","2","0","2"
"2020-05-19","PLAZA CLUCELLAS","0","4","0","4"
"2020-05-19","PRESIDENTE ROCA","0","1","0","1"
"2020-05-19","PUEBLO ANDINO","2","4","1","7"
"2020-05-19","PUEBLO ESTHER","0","23","1","24"
"2020-05-19","PUEBLO IRIGOYEN","0","1","0","1"
"2020-05-19","PUEBLO URANGA","0","1","0","1"
"2020-05-19","PUERTO ARAGON","0","0","1","1"
"2020-05-19","PUERTO GENERAL SAN MARTIN","0","29","1","30"
"2020-05-19","PUERTO RECONQUISTA","0","1","0","1"
"2020-05-19","PUJATO","2","7","0","9"
"2020-05-19","RAFAELA","21","140","4","165"
"2020-05-19","RAMONA","0","2","0","2"
"2020-05-19","RECONQUISTA","0","42","6","48"
"2020-05-19","RECREO","0","21","1","22"
"2020-05-19","RICARDONE","0","8","0","8"
"2020-05-19","RINCON POTRERO","0","1","0","1"
"2020-05-19","ROLDAN","6","47","1","54"
"2020-05-19","ROMANG","0","1","0","1"
"2020-05-19","ROSARIO","103","3690","77","3870"
"2020-05-19","RUFINO","0","31","0","31"
"2020-05-19","SALTO GRANDE","0","2","0","2"
"2020-05-19","SAN ANTONIO DE OBLIGADO","0","1","0","1"
"2020-05-19","SAN CARLOS CENTRO","0","13","0","13"
"2020-05-19","SAN CARLOS SUD","1","1","0","2"
"2020-05-19","SAN CRISTOBAL","0","5","0","5"
"2020-05-19","SANCTI SPIRITU","1","26","0","27"
"2020-05-19","SAN EDUARDO","0","7","0","7"
"2020-05-19","SANFORD","0","2","0","2"
"2020-05-19","SAN FRANCISCO DE SANTA FE","0","1","0","1"
"2020-05-19","SAN GENARO","1","4","0","5"
"2020-05-19","SAN GREGORIO","0","4","0","4"
"2020-05-19","SAN GUILLERMO","0","4","0","4"
"2020-05-19","SAN JAVIER","1","10","1","12"
"2020-05-19","SAN JERONIMO DEL SAUCE","0","1","0","1"
"2020-05-19","SAN JERONIMO NORTE","0","2","0","2"
"2020-05-19","SAN JERONIMO SUD","0","4","0","4"
"2020-05-19","SAN JORGE","0","11","0","11"
"2020-05-19","SAN JOSE DE LA ESQUINA","0","10","2","12"
"2020-05-19","SAN JOSE DEL RINCON","1","12","1","14"
"2020-05-19","SAN JUSTO","0","14","1","15"
"2020-05-19","SAN LORENZO","3","99","5","107"
"2020-05-19","SAN MARTIN DE LAS ESCOBAS","0","2","0","2"
"2020-05-19","SAN MARTIN NORTE","0","1","0","1"
"2020-05-19","SANTA CLARA DE BUENA VISTA","0","2","0","2"
"2020-05-19","SANTA FE","27","668","36","731"
"2020-05-19","SANTA ISABEL","0","8","1","9"
"2020-05-19","SANTA ROSA DE CALCHINES","0","4","0","4"
"2020-05-19","SANTO DOMINGO","0","1","0","1"
"2020-05-19","SANTO TOME","5","96","4","105"
"2020-05-19","SAN VICENTE","0","3","0","3"
"2020-05-19","SA PEREYRA","0","1","0","1"
"2020-05-19","SARGENTO CABRAL","0","1","0","1"
"2020-05-19","SARMIENTO","0","2","0","2"
"2020-05-19","SASTRE","0","4","0","4"
"2020-05-19","SAUCE VIEJO","1","20","0","21"
"2020-05-19","SERODINO","0","2","0","2"
"2020-05-19","SOLDINI","0","5","0","5"
"2020-05-19","SUARDI","0","4","0","4"
"2020-05-19","SUNCHALES","0","7","0","7"
"2020-05-19","SUSANA","0","1","0","1"
"2020-05-19","TACURAL","0","3","0","3"
"2020-05-19","TEODELINA","0","8","0","8"
"2020-05-19","TIMBUES","0","5","3","8"
"2020-05-19","TOSTADO","0","5","0","5"
"2020-05-19","TOTORAS","0","6","0","6"
"2020-05-19","VENADO TUERTO","12","215","6","233"
"2020-05-19","VERA","1","20","1","22"
"2020-05-19","VIDELA","0","1","0","1"
"2020-05-19","VILLA AMELIA","0","1","0","1"
"2020-05-19","VILLA ANA","0","2","1","3"
"2020-05-19","VILLA CAÑAS","0","5","0","5"
"2020-05-19","VILLA CONSTITUCION","9","44","1","54"
"2020-05-19","VILLADA","0","1","0","1"
"2020-05-19","VILLA ELOISA","0","2","0","2"
"2020-05-19","VILLA GOBERNADOR GALVEZ","2","192","7","201"
"2020-05-19","VILLA MINETTI","0","4","0","4"
"2020-05-19","VILLA MUGUETA","0","5","0","5"
"2020-05-19","VILLA OCAMPO","0","4","3","7"
"2020-05-19","VILLA TRINIDAD","0","1","1","2"
"2020-05-19","WHEELWRIGHT","0","7","1","8"
"2020-05-19","ZAVALLA","0","4","0","4"
"2020-05-20","ACEBAL","0","5","0","5"
"2020-05-20","ALBARELLOS","0","1","0","1"
"2020-05-20","ALCORTA","0","6","0","6"
"2020-05-20","ALDAO","0","1","0","1"
"2020-05-20","ALVAREZ","0","6","0","6"
"2020-05-20","ALVEAR","0","10","0","10"
"2020-05-20","AMENABAR","0","1","0","1"
"2020-05-20","ANGEL GALLARDO","0","4","0","4"
"2020-05-20","ANGELICA","0","1","0","1"
"2020-05-20","AREQUITO","0","2","1","3"
"2020-05-20","ARMSTRONG","2","16","1","19"
"2020-05-20","AROCENA","0","5","0","5"
"2020-05-20","ARROYO AGUIAR","0","1","0","1"
"2020-05-20","ARROYO LEYES","0","11","0","11"
"2020-05-20","ARROYO SECO","2","33","0","35"
"2020-05-20","ARRUFO","0","2","0","2"
"2020-05-20","ARTEAGA","0","3","0","3"
"2020-05-20","AVELLANEDA","0","15","0","15"
"2020-05-20","BARRANCAS","0","3","0","3"
"2020-05-20","BERAVEBU","0","1","0","1"
"2020-05-20","BERNARDO DE IRIGOYEN","0","2","0","2"
"2020-05-20","BIGAND","0","15","0","15"
"2020-05-20","BOMBAL","0","6","0","6"
"2020-05-20","BOUQUET","0","1","0","1"
"2020-05-20","BUSTINZA","0","1","0","1"
"2020-05-20","CAFFERATA","0","2","0","2"
"2020-05-20","CALCHAQUI","0","6","1","7"
"2020-05-20","CAÑADA DE GOMEZ","1","43","2","46"
"2020-05-20","CAÑADA DEL UCLE","0","1","0","1"
"2020-05-20","CAPITAN BERMUDEZ","1","58","1","60"
"2020-05-20","CARCARAÑA","0","15","1","16"
"2020-05-20","CARLOS PELLEGRINI","0","7","0","7"
"2020-05-20","CARMEN","0","1","0","1"
"2020-05-20","CARRERAS","0","4","0","4"
"2020-05-20","CARRIZALES","0","2","0","2"
"2020-05-20","CASILDA","2","52","1","55"
"2020-05-20","CAYASTA","1","4","0","5"
"2020-05-20","CERES","0","18","2","20"
"2020-05-20","CHABAS","1","11","0","12"
"2020-05-20","CHAÑAR LADEADO","0","2","0","2"
"2020-05-20","CHOVET","0","9","0","9"
"2020-05-20","CHRISTOPHERSEN","0","0","1","1"
"2020-05-20","CLASON","0","1","0","1"
"2020-05-20","COLONIA MASCIAS","0","1","0","1"
"2020-05-20","COLONIA ROSA","0","1","0","1"
"2020-05-20","CORONDA","0","11","0","11"
"2020-05-20","CORONEL ARNOLD","0","1","0","1"
"2020-05-20","CORONEL BOGADO","0","2","0","2"
"2020-05-20","CORONEL RODOLFO S. DOMINGUEZ","0","2","0","2"
"2020-05-20","CORREA","0","7","0","7"
"2020-05-20","CULULU","0","1","0","1"
"2020-05-20","DESVIO ARIJON","0","2","0","2"
"2020-05-20","DIAZ","0","1","0","1"
"2020-05-20","DIEGO DE ALVEAR","0","4","0","4"
"2020-05-20","ELISA","0","1","0","1"
"2020-05-20","ELORTONDO","4","9","0","13"
"2020-05-20","EL RABON","0","2","0","2"
"2020-05-20","EL TREBOL","0","8","0","8"
"2020-05-20","EMPALME VILLA CONSTITUCION","0","6","0","6"
"2020-05-20","ESPERANZA","1","50","1","52"
"2020-05-20","FIGHIERA","0","4","0","4"
"2020-05-20","FIRMAT","1","26","0","27"
"2020-05-20","FLORENCIA","0","3","0","3"
"2020-05-20","FORTIN OLMOS","0","2","0","2"
"2020-05-20","FRANCK","1","9","0","10"
"2020-05-20","FRAY LUIS BELTRAN","4","33","0","37"
"2020-05-20","FRONTERA","0","26","1","27"
"2020-05-20","FUENTES","0","4","0","4"
"2020-05-20","FUNES","5","60","2","67"
"2020-05-20","GABOTO","0","3","1","4"
"2020-05-20","GALVEZ","9","20","0","29"
"2020-05-20","GENERAL LAGOS","0","5","0","5"
"2020-05-20","GESSLER","0","1","0","1"
"2020-05-20","GOBERNADOR CRESPO","0","3","0","3"
"2020-05-20","GODEKEN","0","4","0","4"
"2020-05-20","GODOY","0","1","0","1"
"2020-05-20","GRANADERO BAIGORRIA","2","114","3","119"
"2020-05-20","GREGORIA PEREZ DE DENIS","0","1","0","1"
"2020-05-20","HELVECIA","2","19","1","22"
"2020-05-20","HUGHES","0","7","1","8"
"2020-05-20","HUMBERTO PRIMO","0","1","0","1"
"2020-05-20","HUMBOLDT","1","2","0","3"
"2020-05-20","IBARLUCEA","0","11","0","11"
"2020-05-20","JOSEFINA","0","2","0","2"
"2020-05-20","JUAN B. MOLINA","0","1","0","1"
"2020-05-20","JUNCAL","0","2","0","2"
"2020-05-20","LABORDEBOY","0","1","0","1"
"2020-05-20","LA BRAVA","0","1","0","1"
"2020-05-20","LA CAROLINA","0","1","0","1"
"2020-05-20","LA CRIOLLA","0","3","0","3"
"2020-05-20","LAGUNA PAIVA","0","7","1","8"
"2020-05-20","LANDETA","0","2","0","2"
"2020-05-20","LANTERI","0","1","0","1"
"2020-05-20","LAS PAREJAS","1","17","0","18"
"2020-05-20","LAS ROSAS","1","19","0","20"
"2020-05-20","LAS TOSCAS","0","3","1","4"
"2020-05-20","LA VANGUARDIA","0","1","0","1"
"2020-05-20","LEHMANN","0","2","0","2"
"2020-05-20","LLAMBI CAMPBELL","3","3","0","6"
"2020-05-20","LOPEZ","0","2","0","2"
"2020-05-20","LOS MOLINOS","0","1","0","1"
"2020-05-20","LOS QUIRQUINCHOS","0","3","0","3"
"2020-05-20","LUIS PALACIOS","0","4","0","4"
"2020-05-20","MACIEL","0","6","1","7"
"2020-05-20","MAGGIOLO","0","4","0","4"
"2020-05-20","MALABRIGO","0","1","0","1"
"2020-05-20","MARGARITA","0","3","0","3"
"2020-05-20","MARIA JUANA","1","7","0","8"
"2020-05-20","MARIA SUSANA","0","4","0","4"
"2020-05-20","MARIA TERESA","0","2","0","2"
"2020-05-20","MAXIMO PAZ","0","3","0","3"
"2020-05-20","MELINCUE","0","1","0","1"
"2020-05-20","MIGUEL TORRES","0","3","0","3"
"2020-05-20","MONJE","0","2","0","2"
"2020-05-20","MONTEFIORE","0","1","0","1"
"2020-05-20","MONTES DE OCA","0","3","0","3"
"2020-05-20","MONTE VERA","0","11","0","11"
"2020-05-20","MOUSSY","0","1","0","1"
"2020-05-20","MURPHY","0","4","0","4"
"2020-05-20","NELSON","0","4","0","4"
"2020-05-20","NUEVO TORINO","0","1","0","1"
"2020-05-20","OLIVEROS","4","19","1","24"
"2020-05-20","PAVON","0","2","0","2"
"2020-05-20","PAVON ARRIBA","0","1","0","1"
"2020-05-20","PEREZ","0","55","1","56"
"2020-05-20","PIAMONTE","0","2","0","2"
"2020-05-20","PILAR","0","1","3","4"
"2020-05-20","PIÑERO","0","2","0","2"
"2020-05-20","PLAZA CLUCELLAS","0","4","0","4"
"2020-05-20","PRESIDENTE ROCA","0","1","0","1"
"2020-05-20","PROGRESO","0","0","1","1"
"2020-05-20","PUEBLO ANDINO","2","5","0","7"
"2020-05-20","PUEBLO ESTHER","0","24","0","24"
"2020-05-20","PUEBLO IRIGOYEN","0","1","0","1"
"2020-05-20","PUEBLO URANGA","0","1","0","1"
"2020-05-20","PUERTO ARAGON","0","1","0","1"
"2020-05-20","PUERTO GENERAL SAN MARTIN","0","30","0","30"
"2020-05-20","PUERTO RECONQUISTA","0","1","0","1"
"2020-05-20","PUJATO","2","7","0","9"
"2020-05-20","RAFAELA","21","140","5","166"
"2020-05-20","RAMONA","0","2","0","2"
"2020-05-20","RECONQUISTA","0","48","2","50"
"2020-05-20","RECREO","0","22","0","22"
"2020-05-20","RICARDONE","0","8","0","8"
"2020-05-20","RINCON POTRERO","0","1","0","1"
"2020-05-20","ROLDAN","6","48","0","54"
"2020-05-20","ROMANG","0","1","1","2"
"2020-05-20","ROSARIO","105","3836","94","4035"
"2020-05-20","RUFINO","0","32","0","32"
"2020-05-20","SALTO GRANDE","0","2","0","2"
"2020-05-20","SAN ANTONIO DE OBLIGADO","0","1","0","1"
"2020-05-20","SAN CARLOS CENTRO","0","13","0","13"
"2020-05-20","SAN CARLOS SUD","1","1","0","2"
"2020-05-20","SAN CRISTOBAL","0","5","0","5"
"2020-05-20","SANCTI SPIRITU","1","26","0","27"
"2020-05-20","SAN EDUARDO","0","7","0","7"
"2020-05-20","SANFORD","0","2","0","2"
"2020-05-20","SAN FRANCISCO DE SANTA FE","0","1","0","1"
"2020-05-20","SAN GENARO","1","4","0","5"
"2020-05-20","SAN GREGORIO","0","5","0","5"
"2020-05-20","SAN GUILLERMO","0","4","0","4"
"2020-05-20","SAN JAVIER","1","11","0","12"
"2020-05-20","SAN JERONIMO DEL SAUCE","0","1","0","1"
"2020-05-20","SAN JERONIMO NORTE","0","2","1","3"
"2020-05-20","SAN JERONIMO SUD","0","4","0","4"
"2020-05-20","SAN JORGE","0","11","0","11"
"2020-05-20","SAN JOSE DE LA ESQUINA","0","10","2","12"
"2020-05-20","SAN JOSE DEL RINCON","1","12","1","14"
"2020-05-20","SAN JUSTO","0","15","1","16"
"2020-05-20","SAN LORENZO","3","101","5","109"
"2020-05-20","SAN MARTIN DE LAS ESCOBAS","0","2","0","2"
"2020-05-20","SAN MARTIN NORTE","0","1","0","1"
"2020-05-20","SANTA CLARA DE BUENA VISTA","0","2","0","2"
"2020-05-20","SANTA FE","27","678","54","759"
"2020-05-20","SANTA ISABEL","0","8","1","9"
"2020-05-20","SANTA ROSA DE CALCHINES","0","4","0","4"
"2020-05-20","SANTO DOMINGO","0","1","0","1"
"2020-05-20","SANTO TOME","5","100","1","106"
"2020-05-20","SAN VICENTE","0","3","0","3"
"2020-05-20","SA PEREYRA","0","1","0","1"
"2020-05-20","SARGENTO CABRAL","0","1","0","1"
"2020-05-20","SARMIENTO","0","2","0","2"
"2020-05-20","SASTRE","0","4","0","4"
"2020-05-20","SAUCE VIEJO","1","20","0","21"
"2020-05-20","SERODINO","0","2","0","2"
"2020-05-20","SOLDINI","0","5","0","5"
"2020-05-20","SUARDI","0","4","0","4"
"2020-05-20","SUNCHALES","0","7","0","7"
"2020-05-20","SUSANA","0","1","0","1"
"2020-05-20","TACURAL","0","3","0","3"
"2020-05-20","TEODELINA","0","8","0","8"
"2020-05-20","TIMBUES","0","6","1","7"
"2020-05-20","TOSTADO","0","5","0","5"
"2020-05-20","TOTORAS","0","6","0","6"
"2020-05-20","VENADO TUERTO","12","220","6","238"
"2020-05-20","VERA","1","20","1","22"
"2020-05-20","VIDELA","0","1","0","1"
"2020-05-20","VILLA AMELIA","0","1","0","1"
"2020-05-20","VILLA ANA","0","2","1","3"
"2020-05-20","VILLA CAÑAS","0","5","0","5"
"2020-05-20","VILLA CONSTITUCION","9","45","1","55"
"2020-05-20","VILLADA","0","1","0","1"
"2020-05-20","VILLA ELOISA","0","2","0","2"
"2020-05-20","VILLA GOBERNADOR GALVEZ","2","197","5","204"
"2020-05-20","VILLA MINETTI","0","4","0","4"
"2020-05-20","VILLA MUGUETA","0","5","0","5"
"2020-05-20","VILLA OCAMPO","0","6","1","7"
"2020-05-20","VILLA TRINIDAD","0","1","1","2"
"2020-05-20","WHEELWRIGHT","0","7","1","8"
"2020-05-20","ZAVALLA","0","4","0","4"
"2020-05-21","ACEBAL","0","5","0","5"
"2020-05-21","ALBARELLOS","0","1","0","1"
"2020-05-21","ALCORTA","0","6","0","6"
"2020-05-21","ALDAO","0","1","0","1"
"2020-05-21","ALVAREZ","0","6","1","7"
"2020-05-21","ALVEAR","0","11","1","12"
"2020-05-21","AMENABAR","0","1","0","1"
"2020-05-21","ANGEL GALLARDO","0","4","0","4"
"2020-05-21","ANGELICA","0","1","0","1"
"2020-05-21","AREQUITO","0","3","0","3"
"2020-05-21","ARMSTRONG","2","17","0","19"
"2020-05-21","AROCENA","0","5","0","5"
"2020-05-21","ARROYO AGUIAR","0","1","0","1"
"2020-05-21","ARROYO LEYES","0","11","0","11"
"2020-05-21","ARROYO SECO","2","35","0","37"
"2020-05-21","ARRUFO","0","2","0","2"
"2020-05-21","ARTEAGA","0","3","0","3"
"2020-05-21","AVELLANEDA","0","15","0","15"
"2020-05-21","BARRANCAS","0","3","0","3"
"2020-05-21","BERAVEBU","0","1","0","1"
"2020-05-21","BERNARDO DE IRIGOYEN","0","2","0","2"
"2020-05-21","BIGAND","0","15","0","15"
"2020-05-21","BOMBAL","0","7","0","7"
"2020-05-21","BOUQUET","0","1","0","1"
"2020-05-21","BUSTINZA","0","1","0","1"
"2020-05-21","CAFFERATA","0","2","0","2"
"2020-05-21","CALCHAQUI","0","7","0","7"
"2020-05-21","CAÑADA DE GOMEZ","1","46","0","47"
"2020-05-21","CAÑADA DEL UCLE","0","1","0","1"
"2020-05-21","CAPITAN BERMUDEZ","1","58","3","62"
"2020-05-21","CARCARAÑA","0","16","1","17"
"2020-05-21","CARLOS PELLEGRINI","0","8","0","8"
"2020-05-21","CARMEN","0","1","0","1"
"2020-05-21","CARRERAS","0","4","0","4"
"2020-05-21","CARRIZALES","0","2","0","2"
"2020-05-21","CASILDA","2","53","1","56"
"2020-05-21","CAYASTA","1","4","0","5"
"2020-05-21","CERES","0","19","0","19"
"2020-05-21","CHABAS","1","11","0","12"
"2020-05-21","CHAÑAR LADEADO","0","2","0","2"
"2020-05-21","CHOVET","0","9","0","9"
"2020-05-21","CHRISTOPHERSEN","0","1","0","1"
"2020-05-21","CLASON","0","1","0","1"
"2020-05-21","COLONIA MASCIAS","0","1","0","1"
"2020-05-21","COLONIA ROSA","0","1","0","1"
"2020-05-21","CORONDA","0","11","0","11"
"2020-05-21","CORONEL ARNOLD","0","1","0","1"
"2020-05-21","CORONEL BOGADO","0","2","0","2"
"2020-05-21","CORONEL RODOLFO S. DOMINGUEZ","0","2","0","2"
"2020-05-21","CORREA","0","7","0","7"
"2020-05-21","CULULU","0","1","0","1"
"2020-05-21","DESVIO ARIJON","0","2","0","2"
"2020-05-21","DIAZ","0","1","0","1"
"2020-05-21","DIEGO DE ALVEAR","0","4","0","4"
"2020-05-21","ELISA","0","1","0","1"
"2020-05-21","ELORTONDO","4","9","0","13"
"2020-05-21","EL RABON","0","2","0","2"
"2020-05-21","EL TREBOL","0","8","0","8"
"2020-05-21","EMPALME VILLA CONSTITUCION","0","7","2","9"
"2020-05-21","ESPERANZA","1","51","0","52"
"2020-05-21","FIGHIERA","0","4","0","4"
"2020-05-21","FIRMAT","1","26","0","27"
"2020-05-21","FLORENCIA","0","3","0","3"
"2020-05-21","FORTIN OLMOS","0","2","0","2"
"2020-05-21","FRANCK","1","9","0","10"
"2020-05-21","FRAY LUIS BELTRAN","4","34","0","38"
"2020-05-21","FRONTERA","0","26","0","26"
"2020-05-21","FUENTES","0","4","0","4"
"2020-05-21","FUNES","5","61","2","68"
"2020-05-21","GABOTO","0","3","1","4"
"2020-05-21","GALVEZ","9","20","0","29"
"2020-05-21","GATO COLORADO","0","0","1","1"
"2020-05-21","GENERAL LAGOS","0","5","0","5"
"2020-05-21","GESSLER","0","1","0","1"
"2020-05-21","GOBERNADOR CRESPO","0","3","0","3"
"2020-05-21","GODEKEN","0","4","0","4"
"2020-05-21","GODOY","0","1","0","1"
"2020-05-21","GRANADERO BAIGORRIA","2","115","4","121"
"2020-05-21","GREGORIA PEREZ DE DENIS","0","1","0","1"
"2020-05-21","HELVECIA","2","18","1","21"
"2020-05-21","HUGHES","0","8","0","8"
"2020-05-21","HUMBERTO PRIMO","0","1","0","1"
"2020-05-21","HUMBOLDT","1","2","0","3"
"2020-05-21","IBARLUCEA","0","11","0","11"
"2020-05-21","JOSEFINA","0","2","0","2"
"2020-05-21","JUAN B. MOLINA","0","1","0","1"
"2020-05-21","JUNCAL","0","2","0","2"
"2020-05-21","LABORDEBOY","0","1","0","1"
"2020-05-21","LA BRAVA","0","1","0","1"
"2020-05-21","LA CAROLINA","0","1","0","1"
"2020-05-21","LA CRIOLLA","0","3","0","3"
"2020-05-21","LAGUNA PAIVA","0","8","0","8"
"2020-05-21","LANDETA","0","2","0","2"
"2020-05-21","LANTERI","0","1","0","1"
"2020-05-21","LAS PAREJAS","1","17","0","18"
"2020-05-21","LAS ROSAS","1","19","0","20"
"2020-05-21","LAS TOSCAS","0","3","1","4"
"2020-05-21","LA VANGUARDIA","0","1","0","1"
"2020-05-21","LEHMANN","0","2","0","2"
"2020-05-21","LLAMBI CAMPBELL","3","3","0","6"
"2020-05-21","LOPEZ","0","2","0","2"
"2020-05-21","LOS MOLINOS","0","1","0","1"
"2020-05-21","LOS QUIRQUINCHOS","0","3","0","3"
"2020-05-21","LUIS PALACIOS","0","4","0","4"
"2020-05-21","MACIEL","0","6","1","7"
"2020-05-21","MAGGIOLO","0","4","0","4"
"2020-05-21","MALABRIGO","0","1","0","1"
"2020-05-21","MARGARITA","0","3","0","3"
"2020-05-21","MARIA JUANA","1","7","1","9"
"2020-05-21","MARIA SUSANA","0","4","0","4"
"2020-05-21","MARIA TERESA","0","2","0","2"
"2020-05-21","MAXIMO PAZ","0","3","0","3"
"2020-05-21","MELINCUE","0","1","0","1"
"2020-05-21","MIGUEL TORRES","0","3","0","3"
"2020-05-21","MONJE","0","2","0","2"
"2020-05-21","MONTEFIORE","0","1","0","1"
"2020-05-21","MONTES DE OCA","0","3","0","3"
"2020-05-21","MONTE VERA","0","11","0","11"
"2020-05-21","MOUSSY","0","1","0","1"
"2020-05-21","MURPHY","0","4","0","4"
"2020-05-21","NELSON","0","4","0","4"
"2020-05-21","NUEVO TORINO","0","1","0","1"
"2020-05-21","OLIVEROS","4","19","1","24"
"2020-05-21","PAVON","0","2","0","2"
"2020-05-21","PAVON ARRIBA","0","1","0","1"
"2020-05-21","PEREZ","0","55","3","58"
"2020-05-21","PIAMONTE","0","2","0","2"
"2020-05-21","PILAR","0","4","0","4"
"2020-05-21","PIÑERO","0","2","0","2"
"2020-05-21","PLAZA CLUCELLAS","0","4","0","4"
"2020-05-21","PRESIDENTE ROCA","0","1","0","1"
"2020-05-21","PROGRESO","0","0","1","1"
"2020-05-21","PUEBLO ANDINO","2","5","0","7"
"2020-05-21","PUEBLO ESTHER","0","24","1","25"
"2020-05-21","PUEBLO IRIGOYEN","0","1","0","1"
"2020-05-21","PUEBLO URANGA","0","1","0","1"
"2020-05-21","PUERTO ARAGON","0","1","0","1"
"2020-05-21","PUERTO GENERAL SAN MARTIN","0","30","0","30"
"2020-05-21","PUERTO RECONQUISTA","0","1","0","1"
"2020-05-21","PUJATO","2","7","0","9"
"2020-05-21","RAFAELA","21","141","4","166"
"2020-05-21","RAMONA","0","2","0","2"
"2020-05-21","RECONQUISTA","0","49","1","50"
"2020-05-21","RECREO","0","22","2","24"
"2020-05-21","RICARDONE","0","9","0","9"
"2020-05-21","RINCON POTRERO","0","1","0","1"
"2020-05-21","ROLDAN","6","51","1","58"
"2020-05-21","ROMANG","0","2","0","2"
"2020-05-21","ROSARIO","108","3958","73","4139"
"2020-05-21","RUFINO","0","32","0","32"
"2020-05-21","SALTO GRANDE","0","2","0","2"
"2020-05-21","SAN ANTONIO DE OBLIGADO","0","1","0","1"
"2020-05-21","SAN CARLOS CENTRO","0","13","0","13"
"2020-05-21","SAN CARLOS SUD","1","1","1","3"
"2020-05-21","SAN CRISTOBAL","0","5","0","5"
"2020-05-21","SANCTI SPIRITU","1","26","0","27"
"2020-05-21","SAN EDUARDO","0","7","0","7"
"2020-05-21","SANFORD","0","3","0","3"
"2020-05-21","SAN FRANCISCO DE SANTA FE","0","1","1","2"
"2020-05-21","SAN GENARO","1","4","0","5"
"2020-05-21","SAN GREGORIO","0","5","0","5"
"2020-05-21","SAN GUILLERMO","0","4","0","4"
"2020-05-21","SAN JAVIER","1","11","0","12"
"2020-05-21","SAN JERONIMO DEL SAUCE","0","1","0","1"
"2020-05-21","SAN JERONIMO NORTE","0","2","1","3"
"2020-05-21","SAN JERONIMO SUD","0","4","0","4"
"2020-05-21","SAN JORGE","0","11","2","13"
"2020-05-21","SAN JOSE DE LA ESQUINA","0","10","2","12"
"2020-05-21","SAN JOSE DEL RINCON","1","12","1","14"
"2020-05-21","SAN JUSTO","0","15","0","15"
"2020-05-21","SAN LORENZO","3","106","6","115"
"2020-05-21","SAN MARTIN DE LAS ESCOBAS","0","2","0","2"
"2020-05-21","SAN MARTIN NORTE","0","1","0","1"
"2020-05-21","SANTA CLARA DE BUENA VISTA","0","2","0","2"
"2020-05-21","SANTA FE","27","687","60","774"
"2020-05-21","SANTA ISABEL","0","8","1","9"
"2020-05-21","SANTA ROSA DE CALCHINES","0","4","0","4"
"2020-05-21","SANTO DOMINGO","0","1","1","2"
"2020-05-21","SANTO TOME","5","101","1","107"
"2020-05-21","SAN VICENTE","0","3","0","3"
"2020-05-21","SA PEREYRA","0","1","0","1"
"2020-05-21","SARGENTO CABRAL","0","1","1","2"
"2020-05-21","SARMIENTO","0","2","0","2"
"2020-05-21","SASTRE","0","4","0","4"
"2020-05-21","SAUCE VIEJO","1","20","0","21"
"2020-05-21","SERODINO","0","2","0","2"
"2020-05-21","SOLDINI","0","5","0","5"
"2020-05-21","SUARDI","0","4","0","4"
"2020-05-21","SUNCHALES","0","7","0","7"
"2020-05-21","SUSANA","0","1","0","1"
"2020-05-21","TACURAL","0","3","0","3"
"2020-05-21","TEODELINA","0","8","0","8"
"2020-05-21","TIMBUES","0","6","1","7"
"2020-05-21","TOSTADO","0","5","0","5"
"2020-05-21","TOTORAS","0","6","0","6"
"2020-05-21","VENADO TUERTO","12","221","8","241"
"2020-05-21","VERA","1","20","1","22"
"2020-05-21","VIDELA","0","1","0","1"
"2020-05-21","VILLA AMELIA","0","1","0","1"
"2020-05-21","VILLA ANA","0","2","1","3"
"2020-05-21","VILLA CAÑAS","0","5","0","5"
"2020-05-21","VILLA CONSTITUCION","9","46","2","57"
"2020-05-21","VILLADA","0","1","0","1"
"2020-05-21","VILLA ELOISA","0","2","0","2"
"2020-05-21","VILLA GOBERNADOR GALVEZ","2","198","5","205"
"2020-05-21","VILLA MINETTI","0","4","0","4"
"2020-05-21","VILLA MUGUETA","0","5","0","5"
"2020-05-21","VILLA OCAMPO","0","6","1","7"
"2020-05-21","VILLA TRINIDAD","0","2","0","2"
"2020-05-21","WHEELWRIGHT","0","7","1","8"
"2020-05-21","ZAVALLA","0","4","0","4"
"2020-05-22","ACEBAL","0","5","0","5"
"2020-05-22","ALBARELLOS","0","1","0","1"
"2020-05-22","ALCORTA","0","6","0","6"
"2020-05-22","ALDAO","0","1","0","1"
"2020-05-22","ALVAREZ","0","7","0","7"
"2020-05-22","ALVEAR","0","12","0","12"
"2020-05-22","AMENABAR","0","1","0","1"
"2020-05-22","ANGEL GALLARDO","0","4","0","4"
"2020-05-22","ANGELICA","0","1","0","1"
"2020-05-22","AREQUITO","0","3","0","3"
"2020-05-22","ARMSTRONG","2","17","0","19"
"2020-05-22","AROCENA","0","5","0","5"
"2020-05-22","ARROYO AGUIAR","0","1","0","1"
"2020-05-22","ARROYO LEYES","0","11","0","11"
"2020-05-22","ARROYO SECO","2","35","1","38"
"2020-05-22","ARRUFO","0","2","0","2"
"2020-05-22","ARTEAGA","0","3","0","3"
"2020-05-22","AVELLANEDA","0","15","1","16"
"2020-05-22","BARRANCAS","0","3","0","3"
"2020-05-22","BERAVEBU","0","1","0","1"
"2020-05-22","BERNARDO DE IRIGOYEN","0","2","0","2"
"2020-05-22","BIGAND","0","15","2","17"
"2020-05-22","BOMBAL","0","7","0","7"
"2020-05-22","BOUQUET","0","1","0","1"
"2020-05-22","BUSTINZA","0","1","0","1"
"2020-05-22","CAFFERATA","0","2","0","2"
"2020-05-22","CALCHAQUI","0","7","0","7"
"2020-05-22","CAÑADA DE GOMEZ","1","46","0","47"
"2020-05-22","CAÑADA DEL UCLE","0","1","0","1"
"2020-05-22","CAPITAN BERMUDEZ","1","61","2","64"
"2020-05-22","CARCARAÑA","0","18","0","18"
"2020-05-22","CARLOS PELLEGRINI","0","8","0","8"
"2020-05-22","CARMEN","0","1","0","1"
"2020-05-22","CARRERAS","0","4","0","4"
"2020-05-22","CARRIZALES","0","2","0","2"
"2020-05-22","CASILDA","2","54","2","58"
"2020-05-22","CAYASTA","1","4","0","5"
"2020-05-22","CERES","0","19","0","19"
"2020-05-22","CHABAS","1","11","0","12"
"2020-05-22","CHAÑAR LADEADO","0","2","0","2"
"2020-05-22","CHOVET","0","9","0","9"
"2020-05-22","CHRISTOPHERSEN","0","1","0","1"
"2020-05-22","CLASON","0","1","0","1"
"2020-05-22","COLONIA MASCIAS","0","1","0","1"
"2020-05-22","COLONIA ROSA","0","1","0","1"
"2020-05-22","CORONDA","0","11","0","11"
"2020-05-22","CORONEL ARNOLD","0","1","0","1"
"2020-05-22","CORONEL BOGADO","0","2","0","2"
"2020-05-22","CORONEL RODOLFO S. DOMINGUEZ","0","2","0","2"
"2020-05-22","CORREA","0","7","0","7"
"2020-05-22","CULULU","0","1","0","1"
"2020-05-22","DESVIO ARIJON","0","2","0","2"
"2020-05-22","DIAZ","0","1","0","1"
"2020-05-22","DIEGO DE ALVEAR","0","4","0","4"
"2020-05-22","ELISA","0","1","0","1"
"2020-05-22","ELORTONDO","4","10","0","14"
"2020-05-22","EL RABON","0","2","0","2"
"2020-05-22","EL TREBOL","0","8","0","8"
"2020-05-22","EMPALME VILLA CONSTITUCION","0","9","0","9"
"2020-05-22","ESPERANZA","1","51","0","52"
"2020-05-22","FIGHIERA","0","4","0","4"
"2020-05-22","FIRMAT","1","28","0","29"
"2020-05-22","FLORENCIA","0","3","0","3"
"2020-05-22","FORTIN OLMOS","0","2","0","2"
"2020-05-22","FRANCK","1","9","0","10"
"2020-05-22","FRAY LUIS BELTRAN","4","34","0","38"
"2020-05-22","FRONTERA","0","26","2","28"
"2020-05-22","FUENTES","0","4","0","4"
"2020-05-22","FUNES","5","62","3","70"
"2020-05-22","GABOTO","0","3","1","4"
"2020-05-22","GALVEZ","9","20","0","29"
"2020-05-22","GATO COLORADO","0","1","0","1"
"2020-05-22","GENERAL LAGOS","0","5","0","5"
"2020-05-22","GESSLER","0","1","0","1"
"2020-05-22","GOBERNADOR CRESPO","0","3","0","3"
"2020-05-22","GODEKEN","0","4","0","4"
"2020-05-22","GODOY","0","1","0","1"
"2020-05-22","GRANADERO BAIGORRIA","2","119","0","121"
"2020-05-22","GREGORIA PEREZ DE DENIS","0","1","0","1"
"2020-05-22","HELVECIA","2","18","1","21"
"2020-05-22","HUGHES","0","8","0","8"
"2020-05-22","HUMBERTO PRIMO","0","1","0","1"
"2020-05-22","HUMBOLDT","1","2","0","3"
"2020-05-22","IBARLUCEA","0","11","0","11"
"2020-05-22","JOSEFINA","0","2","0","2"
"2020-05-22","JUAN B. MOLINA","0","1","0","1"
"2020-05-22","JUNCAL","0","2","0","2"
"2020-05-22","LABORDEBOY","0","2","0","2"
"2020-05-22","LA BRAVA","0","1","0","1"
"2020-05-22","LA CAROLINA","0","1","0","1"
"2020-05-22","LA CRIOLLA","0","3","0","3"
"2020-05-22","LAGUNA PAIVA","0","8","0","8"
"2020-05-22","LANDETA","0","2","0","2"
"2020-05-22","LANTERI","0","1","0","1"
"2020-05-22","LAS PAREJAS","1","17","0","18"
"2020-05-22","LAS ROSAS","1","19","0","20"
"2020-05-22","LAS TOSCAS","0","4","0","4"
"2020-05-22","LA VANGUARDIA","0","1","0","1"
"2020-05-22","LEHMANN","0","2","0","2"
"2020-05-22","LLAMBI CAMPBELL","3","3","0","6"
"2020-05-22","LOPEZ","0","2","0","2"
"2020-05-22","LOS MOLINOS","0","1","0","1"
"2020-05-22","LOS QUIRQUINCHOS","0","3","0","3"
"2020-05-22","LUIS PALACIOS","0","4","0","4"
"2020-05-22","MACIEL","0","6","1","7"
"2020-05-22","MAGGIOLO","0","4","0","4"
"2020-05-22","MALABRIGO","0","1","0","1"
"2020-05-22","MARGARITA","0","3","0","3"
"2020-05-22","MARIA JUANA","1","8","0","9"
"2020-05-22","MARIA SUSANA","0","4","0","4"
"2020-05-22","MARIA TERESA","0","2","0","2"
"2020-05-22","MAXIMO PAZ","0","3","0","3"
"2020-05-22","MELINCUE","0","1","0","1"
"2020-05-22","MIGUEL TORRES","0","3","0","3"
"2020-05-22","MONJE","0","2","0","2"
"2020-05-22","MONTEFIORE","0","1","0","1"
"2020-05-22","MONTES DE OCA","0","3","0","3"
"2020-05-22","MONTE VERA","0","12","0","12"
"2020-05-22","MOUSSY","0","1","0","1"
"2020-05-22","MURPHY","0","4","0","4"
"2020-05-22","NELSON","0","4","0","4"
"2020-05-22","NUEVO TORINO","0","1","0","1"
"2020-05-22","OLIVEROS","4","20","1","25"
"2020-05-22","PAVON","0","2","0","2"
"2020-05-22","PAVON ARRIBA","0","1","0","1"
"2020-05-22","PEREZ","0","58","2","60"
"2020-05-22","PIAMONTE","0","2","0","2"
"2020-05-22","PILAR","0","4","0","4"
"2020-05-22","PIÑERO","0","2","0","2"
"2020-05-22","PLAZA CLUCELLAS","0","4","1","5"
"2020-05-22","PRESIDENTE ROCA","0","1","0","1"
"2020-05-22","PROGRESO","0","1","0","1"
"2020-05-22","PUEBLO ANDINO","2","5","0","7"
"2020-05-22","PUEBLO ESTHER","0","25","0","25"
"2020-05-22","PUEBLO IRIGOYEN","0","1","0","1"
"2020-05-22","PUEBLO URANGA","0","1","0","1"
"2020-05-22","PUERTO ARAGON","0","1","0","1"
"2020-05-22","PUERTO GENERAL SAN MARTIN","0","30","0","30"
"2020-05-22","PUERTO RECONQUISTA","0","1","0","1"
"2020-05-22","PUJATO","2","7","0","9"
"2020-05-22","RAFAELA","21","141","6","168"
"2020-05-22","RAMONA","0","2","0","2"
"2020-05-22","RECONQUISTA","0","49","5","54"
"2020-05-22","RECREO","0","23","0","23"
"2020-05-22","RICARDONE","0","9","0","9"
"2020-05-22","RINCON POTRERO","0","1","0","1"
"2020-05-22","ROLDAN","6","52","0","58"
"2020-05-22","ROMANG","0","2","0","2"
"2020-05-22","ROSARIO","112","4075","86","4273"
"2020-05-22","RUFINO","0","32","0","32"
"2020-05-22","SALTO GRANDE","0","2","0","2"
"2020-05-22","SAN ANTONIO DE OBLIGADO","0","1","0","1"
"2020-05-22","SAN CARLOS CENTRO","0","13","0","13"
"2020-05-22","SAN CARLOS SUD","1","2","0","3"
"2020-05-22","SAN CRISTOBAL","0","5","0","5"
"2020-05-22","SANCTI SPIRITU","1","26","0","27"
"2020-05-22","SAN EDUARDO","0","7","0","7"
"2020-05-22","SAN FABIAN","0","0","1","1"
"2020-05-22","SANFORD","0","3","0","3"
"2020-05-22","SAN FRANCISCO DE SANTA FE","0","2","0","2"
"2020-05-22","SAN GENARO","1","4","0","5"
"2020-05-22","SAN GREGORIO","0","5","0","5"
"2020-05-22","SAN GUILLERMO","0","4","0","4"
"2020-05-22","SAN JAVIER","1","11","0","12"
"2020-05-22","SAN JERONIMO DEL SAUCE","0","1","0","1"
"2020-05-22","SAN JERONIMO NORTE","0","3","0","3"
"2020-05-22","SAN JERONIMO SUD","0","4","0","4"
"2020-05-22","SAN JORGE","0","13","1","14"
"2020-05-22","SAN JOSE DE LA ESQUINA","0","10","2","12"
"2020-05-22","SAN JOSE DEL RINCON","1","12","2","15"
"2020-05-22","SAN JUSTO","0","15","0","15"
"2020-05-22","SAN LORENZO","3","109","3","115"
"2020-05-22","SAN MARTIN DE LAS ESCOBAS","0","3","0","3"
"2020-05-22","SAN MARTIN NORTE","0","1","0","1"
"2020-05-22","SANTA CLARA DE BUENA VISTA","0","2","0","2"
"2020-05-22","SANTA FE","27","725","36","788"
"2020-05-22","SANTA ISABEL","0","8","1","9"
"2020-05-22","SANTA ROSA DE CALCHINES","0","5","0","5"
"2020-05-22","SANTO DOMINGO","0","1","1","2"
"2020-05-22","SANTO TOME","5","102","1","108"
"2020-05-22","SAN VICENTE","0","3","0","3"
"2020-05-22","SA PEREYRA","0","1","0","1"
"2020-05-22","SARGENTO CABRAL","0","2","0","2"
"2020-05-22","SARMIENTO","0","2","0","2"
"2020-05-22","SASTRE","0","4","0","4"
"2020-05-22","SAUCE VIEJO","1","20","1","22"
"2020-05-22","SERODINO","0","2","0","2"
"2020-05-22","SOLDINI","0","5","0","5"
"2020-05-22","SUARDI","0","4","0","4"
"2020-05-22","SUNCHALES","0","7","0","7"
"2020-05-22","SUSANA","0","1","0","1"
"2020-05-22","TACURAL","0","3","0","3"
"2020-05-22","TEODELINA","0","8","0","8"
"2020-05-22","TIMBUES","0","6","1","7"
"2020-05-22","TOSTADO","0","5","0","5"
"2020-05-22","TOTORAS","0","6","0","6"
"2020-05-22","VENADO TUERTO","12","226","6","244"
"2020-05-22","VERA","1","21","0","22"
"2020-05-22","VIDELA","0","1","0","1"
"2020-05-22","VILLA AMELIA","0","1","0","1"
"2020-05-22","VILLA ANA","0","2","1","3"
"2020-05-22","VILLA CAÑAS","0","5","0","5"
"2020-05-22","VILLA CONSTITUCION","9","48","0","57"
"2020-05-22","VILLADA","0","1","0","1"
"2020-05-22","VILLA ELOISA","0","2","0","2"
"2020-05-22","VILLA GOBERNADOR GALVEZ","2","198","10","210"
"2020-05-22","VILLA MINETTI","0","4","0","4"
"2020-05-22","VILLA MUGUETA","0","5","0","5"
"2020-05-22","VILLA OCAMPO","0","6","1","7"
"2020-05-22","VILLA TRINIDAD","0","2","0","2"
"2020-05-22","WHEELWRIGHT","0","8","1","9"
"2020-05-22","ZAVALLA","0","4","0","4"
"2020-05-23","ACEBAL","0","5","0","5"
"2020-05-23","ALBARELLOS","0","1","0","1"
"2020-05-23","ALCORTA","0","6","0","6"
"2020-05-23","ALDAO","0","1","0","1"
"2020-05-23","ALVAREZ","0","7","0","7"
"2020-05-23","ALVEAR","0","12","0","12"
"2020-05-23","AMENABAR","0","1","0","1"
"2020-05-23","ANGEL GALLARDO","0","4","0","4"
"2020-05-23","ANGELICA","0","1","0","1"
"2020-05-23","AREQUITO","0","3","0","3"
"2020-05-23","ARMSTRONG","2","17","0","19"
"2020-05-23","AROCENA","0","5","0","5"
"2020-05-23","ARROYO AGUIAR","0","1","0","1"
"2020-05-23","ARROYO LEYES","0","11","0","11"
"2020-05-23","ARROYO SECO","2","36","2","40"
"2020-05-23","ARRUFO","0","2","0","2"
"2020-05-23","ARTEAGA","0","3","0","3"
"2020-05-23","AVELLANEDA","0","16","1","17"
"2020-05-23","BARRANCAS","0","3","0","3"
"2020-05-23","BERAVEBU","0","1","0","1"
"2020-05-23","BERNA","0","1","0","1"
"2020-05-23","BERNARDO DE IRIGOYEN","0","2","0","2"
"2020-05-23","BIGAND","0","15","2","17"
"2020-05-23","BOMBAL","0","7","0","7"
"2020-05-23","BOUQUET","0","1","0","1"
"2020-05-23","BUSTINZA","0","1","0","1"
"2020-05-23","CAFFERATA","0","2","0","2"
"2020-05-23","CALCHAQUI","0","8","0","8"
"2020-05-23","CAÑADA DE GOMEZ","1","46","0","47"
"2020-05-23","CAÑADA DEL UCLE","0","1","0","1"
"2020-05-23","CAPITAN BERMUDEZ","1","61","3","65"
"2020-05-23","CARCARAÑA","0","18","0","18"
"2020-05-23","CARLOS PELLEGRINI","0","9","0","9"
"2020-05-23","CARMEN","0","1","0","1"
"2020-05-23","CARRERAS","0","4","0","4"
"2020-05-23","CARRIZALES","0","2","0","2"
"2020-05-23","CASILDA","2","54","2","58"
"2020-05-23","CAYASTA","1","4","0","5"
"2020-05-23","CERES","0","19","0","19"
"2020-05-23","CHABAS","1","11","1","13"
"2020-05-23","CHAÑAR LADEADO","0","2","0","2"
"2020-05-23","CHOVET","0","9","0","9"
"2020-05-23","CHRISTOPHERSEN","0","1","0","1"
"2020-05-23","CLASON","0","1","0","1"
"2020-05-23","COLONIA MASCIAS","0","1","0","1"
"2020-05-23","COLONIA ROSA","0","1","0","1"
"2020-05-23","CORONDA","0","11","0","11"
"2020-05-23","CORONEL ARNOLD","0","1","0","1"
"2020-05-23","CORONEL BOGADO","0","2","0","2"
"2020-05-23","CORONEL RODOLFO S. DOMINGUEZ","0","2","0","2"
"2020-05-23","CORREA","0","7","0","7"
"2020-05-23","CULULU","0","1","0","1"
"2020-05-23","DESVIO ARIJON","0","2","0","2"
"2020-05-23","DIAZ","0","1","0","1"
"2020-05-23","DIEGO DE ALVEAR","0","4","0","4"
"2020-05-23","EL ARAZA","0","1","0","1"
"2020-05-23","ELISA","0","1","0","1"
"2020-05-23","ELORTONDO","4","10","0","14"
"2020-05-23","EL RABON","0","2","0","2"
"2020-05-23","EL TREBOL","0","9","0","9"
"2020-05-23","EMPALME VILLA CONSTITUCION","0","9","0","9"
"2020-05-23","ESPERANZA","1","51","0","52"
"2020-05-23","FIGHIERA","0","4","0","4"
"2020-05-23","FIRMAT","1","28","1","30"
"2020-05-23","FLORENCIA","0","3","0","3"
"2020-05-23","FORTIN OLMOS","0","2","0","2"
"2020-05-23","FRANCK","1","9","0","10"
"2020-05-23","FRAY LUIS BELTRAN","4","34","0","38"
"2020-05-23","FRONTERA","0","26","1","27"
"2020-05-23","FUENTES","0","4","0","4"
"2020-05-23","FUNES","5","62","3","70"
"2020-05-23","GABOTO","0","3","1","4"
"2020-05-23","GALVEZ","9","20","0","29"
"2020-05-23","GATO COLORADO","0","1","0","1"
"2020-05-23","GENERAL LAGOS","0","5","0","5"
"2020-05-23","GESSLER","0","1","0","1"
"2020-05-23","GOBERNADOR CRESPO","0","3","0","3"
"2020-05-23","GODEKEN","0","4","0","4"
"2020-05-23","GODOY","0","1","0","1"
"2020-05-23","GRANADERO BAIGORRIA","2","120","2","124"
"2020-05-23","GREGORIA PEREZ DE DENIS","0","1","0","1"
"2020-05-23","HELVECIA","2","18","1","21"
"2020-05-23","HUGHES","0","8","0","8"
"2020-05-23","HUMBERTO PRIMO","0","1","0","1"
"2020-05-23","HUMBOLDT","1","2","0","3"
"2020-05-23","IBARLUCEA","0","11","0","11"
"2020-05-23","JOSEFINA","0","2","0","2"
"2020-05-23","JUAN B. MOLINA","0","1","0","1"
"2020-05-23","JUNCAL","0","2","0","2"
"2020-05-23","LABORDEBOY","0","2","0","2"
"2020-05-23","LA BRAVA","0","1","0","1"
"2020-05-23","LA CAROLINA","0","1","0","1"
"2020-05-23","LA CRIOLLA","0","3","0","3"
"2020-05-23","LAGUNA PAIVA","0","8","0","8"
"2020-05-23","LANDETA","0","2","0","2"
"2020-05-23","LANTERI","0","1","0","1"
"2020-05-23","LAS PAREJAS","1","17","0","18"
"2020-05-23","LAS ROSAS","1","19","1","21"
"2020-05-23","LAS TOSCAS","0","4","0","4"
"2020-05-23","LA VANGUARDIA","0","1","0","1"
"2020-05-23","LEHMANN","0","2","0","2"
"2020-05-23","LLAMBI CAMPBELL","3","3","0","6"
"2020-05-23","LOPEZ","0","2","0","2"
"2020-05-23","LOS MOLINOS","0","1","0","1"
"2020-05-23","LOS QUIRQUINCHOS","0","3","0","3"
"2020-05-23","LUIS PALACIOS","0","4","0","4"
"2020-05-23","MACIEL","0","6","1","7"
"2020-05-23","MAGGIOLO","0","4","0","4"
"2020-05-23","MALABRIGO","0","1","0","1"
"2020-05-23","MARGARITA","0","3","0","3"
"2020-05-23","MARIA JUANA","1","8","0","9"
"2020-05-23","MARIA SUSANA","0","4","0","4"
"2020-05-23","MARIA TERESA","0","2","0","2"
"2020-05-23","MAXIMO PAZ","0","3","0","3"
"2020-05-23","MELINCUE","0","1","0","1"
"2020-05-23","MIGUEL TORRES","0","3","0","3"
"2020-05-23","MONJE","0","2","0","2"
"2020-05-23","MONTEFIORE","0","1","0","1"
"2020-05-23","MONTES DE OCA","0","3","0","3"
"2020-05-23","MONTE VERA","0","12","1","13"
"2020-05-23","MOUSSY","0","1","0","1"
"2020-05-23","MURPHY","0","4","0","4"
"2020-05-23","NELSON","0","4","0","4"
"2020-05-23","NUEVO TORINO","0","1","0","1"
"2020-05-23","OLIVEROS","4","20","1","25"
"2020-05-23","PAVON","0","2","0","2"
"2020-05-23","PAVON ARRIBA","0","1","0","1"
"2020-05-23","PEREZ","0","58","2","60"
"2020-05-23","PIAMONTE","0","2","0","2"
"2020-05-23","PILAR","0","4","0","4"
"2020-05-23","PIÑERO","0","2","0","2"
"2020-05-23","PLAZA CLUCELLAS","0","4","1","5"
"2020-05-23","PRESIDENTE ROCA","0","1","0","1"
"2020-05-23","PROGRESO","0","1","0","1"
"2020-05-23","PUEBLO ANDINO","2","5","0","7"
"2020-05-23","PUEBLO ESTHER","0","25","0","25"
"2020-05-23","PUEBLO IRIGOYEN","0","1","0","1"
"2020-05-23","PUEBLO URANGA","0","1","0","1"
"2020-05-23","PUERTO ARAGON","0","1","0","1"
"2020-05-23","PUERTO GENERAL SAN MARTIN","0","30","1","31"
"2020-05-23","PUERTO RECONQUISTA","0","1","0","1"
"2020-05-23","PUJATO","2","7","1","10"
"2020-05-23","RAFAELA","21","141","6","168"
"2020-05-23","RAMONA","0","2","0","2"
"2020-05-23","RECONQUISTA","0","52","5","57"
"2020-05-23","RECREO","0","23","0","23"
"2020-05-23","RICARDONE","0","9","0","9"
"2020-05-23","RINCON POTRERO","0","1","0","1"
"2020-05-23","ROLDAN","6","52","0","58"
"2020-05-23","ROMANG","0","2","0","2"
"2020-05-23","ROSARIO","112","4115","177","4404"
"2020-05-23","RUFINO","0","32","0","32"
"2020-05-23","SALTO GRANDE","0","2","0","2"
"2020-05-23","SAN ANTONIO DE OBLIGADO","0","1","0","1"
"2020-05-23","SAN CARLOS CENTRO","0","13","0","13"
"2020-05-23","SAN CARLOS SUD","1","2","0","3"
"2020-05-23","SAN CRISTOBAL","0","5","0","5"
"2020-05-23","SANCTI SPIRITU","1","26","0","27"
"2020-05-23","SAN EDUARDO","0","7","0","7"
"2020-05-23","SAN FABIAN","0","0","1","1"
"2020-05-23","SANFORD","0","3","0","3"
"2020-05-23","SAN FRANCISCO DE SANTA FE","0","2","0","2"
"2020-05-23","SAN GENARO","1","4","0","5"
"2020-05-23","SAN GREGORIO","0","5","0","5"
"2020-05-23","SAN GUILLERMO","0","4","0","4"
"2020-05-23","SAN JAVIER","1","11","0","12"
"2020-05-23","SAN JERONIMO DEL SAUCE","0","1","0","1"
"2020-05-23","SAN JERONIMO NORTE","0","3","0","3"
"2020-05-23","SAN JERONIMO SUD","0","4","0","4"
"2020-05-23","SAN JORGE","0","13","1","14"
"2020-05-23","SAN JOSE DE LA ESQUINA","0","10","2","12"
"2020-05-23","SAN JOSE DEL RINCON","1","12","2","15"
"2020-05-23","SAN JUSTO","0","15","0","15"
"2020-05-23","SAN LORENZO","3","109","5","117"
"2020-05-23","SAN MARTIN DE LAS ESCOBAS","0","3","0","3"
"2020-05-23","SAN MARTIN NORTE","0","1","0","1"
"2020-05-23","SANTA CLARA DE BUENA VISTA","0","2","0","2"
"2020-05-23","SANTA FE","27","726","37","790"
"2020-05-23","SANTA ISABEL","0","8","1","9"
"2020-05-23","SANTA ROSA DE CALCHINES","0","5","0","5"
"2020-05-23","SANTO DOMINGO","0","1","1","2"
"2020-05-23","SANTO TOME","5","103","1","109"
"2020-05-23","SAN VICENTE","0","3","0","3"
"2020-05-23","SA PEREYRA","0","1","0","1"
"2020-05-23","SARGENTO CABRAL","0","2","0","2"
"2020-05-23","SARMIENTO","0","2","0","2"
"2020-05-23","SASTRE","0","4","0","4"
"2020-05-23","SAUCE VIEJO","1","20","1","22"
"2020-05-23","SERODINO","0","2","0","2"
"2020-05-23","SOLDINI","0","5","0","5"
"2020-05-23","SUARDI","0","4","0","4"
"2020-05-23","SUNCHALES","0","7","0","7"
"2020-05-23","SUSANA","0","1","0","1"
"2020-05-23","TACURAL","0","3","0","3"
"2020-05-23","TEODELINA","0","8","0","8"
"2020-05-23","TIMBUES","0","6","1","7"
"2020-05-23","TOSTADO","0","5","0","5"
"2020-05-23","TOTORAS","0","6","0","6"
"2020-05-23","VENADO TUERTO","12","226","7","245"
"2020-05-23","VERA","1","21","0","22"
"2020-05-23","VIDELA","0","1","0","1"
"2020-05-23","VILLA AMELIA","0","1","0","1"
"2020-05-23","VILLA ANA","0","2","1","3"
"2020-05-23","VILLA CAÑAS","0","5","0","5"
"2020-05-23","VILLA CONSTITUCION","9","48","1","58"
"2020-05-23","VILLADA","0","1","0","1"
"2020-05-23","VILLA ELOISA","0","2","0","2"
"2020-05-23","VILLA GOBERNADOR GALVEZ","2","198","11","211"
"2020-05-23","VILLA MINETTI","0","4","0","4"
"2020-05-23","VILLA MUGUETA","0","5","0","5"
"2020-05-23","VILLA OCAMPO","0","6","1","7"
"2020-05-23","VILLA TRINIDAD","0","2","0","2"
"2020-05-23","WHEELWRIGHT","0","8","1","9"
"2020-05-23","ZAVALLA","0","4","0","4"
"2020-05-24","ACEBAL","0","5","0","5"
"2020-05-24","ALBARELLOS","0","1","0","1"
"2020-05-24","ALCORTA","0","6","0","6"
"2020-05-24","ALDAO","0","1","0","1"
"2020-05-24","ALVAREZ","0","7","0","7"
"2020-05-24","ALVEAR","0","12","0","12"
"2020-05-24","AMENABAR","0","1","0","1"
"2020-05-24","ANGEL GALLARDO","0","4","0","4"
"2020-05-24","ANGELICA","0","1","0","1"
"2020-05-24","AREQUITO","0","3","0","3"
"2020-05-24","ARMSTRONG","2","17","0","19"
"2020-05-24","AROCENA","0","5","0","5"
"2020-05-24","ARROYO AGUIAR","0","1","0","1"
"2020-05-24","ARROYO LEYES","0","11","0","11"
"2020-05-24","ARROYO SECO","2","38","0","40"
"2020-05-24","ARRUFO","0","2","0","2"
"2020-05-24","ARTEAGA","0","3","0","3"
"2020-05-24","AVELLANEDA","0","18","1","19"
"2020-05-24","BARRANCAS","0","3","0","3"
"2020-05-24","BERAVEBU","0","1","0","1"
"2020-05-24","BERNA","0","1","0","1"
"2020-05-24","BERNARDO DE IRIGOYEN","0","2","0","2"
"2020-05-24","BIGAND","0","17","0","17"
"2020-05-24","BOMBAL","0","7","0","7"
"2020-05-24","BOUQUET","0","1","0","1"
"2020-05-24","BUSTINZA","0","1","0","1"
"2020-05-24","CAFFERATA","0","2","0","2"
"2020-05-24","CALCHAQUI","0","8","2","10"
"2020-05-24","CAÑADA DE GOMEZ","1","46","0","47"
"2020-05-24","CAÑADA DEL UCLE","0","1","0","1"
"2020-05-24","CAPITAN BERMUDEZ","1","63","1","65"
"2020-05-24","CARCARAÑA","0","18","0","18"
"2020-05-24","CARLOS PELLEGRINI","0","9","0","9"
"2020-05-24","CARMEN","0","1","1","2"
"2020-05-24","CARRERAS","0","4","0","4"
"2020-05-24","CARRIZALES","0","2","0","2"
"2020-05-24","CASAS","0","1","0","1"
"2020-05-24","CASILDA","2","54","3","59"
"2020-05-24","CAYASTA","1","4","0","5"
"2020-05-24","CERES","0","19","0","19"
"2020-05-24","CHABAS","1","11","1","13"
"2020-05-24","CHAÑAR LADEADO","0","2","0","2"
"2020-05-24","CHOVET","0","9","0","9"
"2020-05-24","CHRISTOPHERSEN","0","1","0","1"
"2020-05-24","CLASON","0","1","0","1"
"2020-05-24","COLONIA MASCIAS","0","1","0","1"
"2020-05-24","COLONIA ROSA","0","1","0","1"
"2020-05-24","CORONDA","0","11","0","11"
"2020-05-24","CORONEL ARNOLD","0","1","0","1"
"2020-05-24","CORONEL BOGADO","0","2","0","2"
"2020-05-24","CORONEL RODOLFO S. DOMINGUEZ","0","2","0","2"
"2020-05-24","CORREA","0","7","0","7"
"2020-05-24","CULULU","0","1","0","1"
"2020-05-24","DESVIO ARIJON","0","2","1","3"
"2020-05-24","DIAZ","0","1","0","1"
"2020-05-24","DIEGO DE ALVEAR","0","4","0","4"
"2020-05-24","EL ARAZA","0","1","0","1"
"2020-05-24","ELISA","0","1","0","1"
"2020-05-24","ELORTONDO","4","10","0","14"
"2020-05-24","EL RABON","0","2","0","2"
"2020-05-24","EL TREBOL","0","9","0","9"
"2020-05-24","EMPALME VILLA CONSTITUCION","0","9","0","9"
"2020-05-24","ESPERANZA","1","51","0","52"
"2020-05-24","FIGHIERA","0","5","0","5"
"2020-05-24","FIRMAT","1","30","0","31"
"2020-05-24","FLORENCIA","0","3","0","3"
"2020-05-24","FORTIN OLMOS","0","2","0","2"
"2020-05-24","FRANCK","1","9","0","10"
"2020-05-24","FRAY LUIS BELTRAN","4","34","1","39"
"2020-05-24","FRONTERA","0","27","0","27"
"2020-05-24","FUENTES","0","4","0","4"
"2020-05-24","FUNES","5","64","2","71"
"2020-05-24","GABOTO","0","3","1","4"
"2020-05-24","GALVEZ","9","20","0","29"
"2020-05-24","GATO COLORADO","0","1","0","1"
"2020-05-24","GENERAL LAGOS","0","5","0","5"
"2020-05-24","GESSLER","0","1","0","1"
"2020-05-24","GOBERNADOR CRESPO","0","3","0","3"
"2020-05-24","GODEKEN","0","4","0","4"
"2020-05-24","GODOY","0","1","0","1"
"2020-05-24","GRANADERO BAIGORRIA","2","122","0","124"
"2020-05-24","GREGORIA PEREZ DE DENIS","0","1","0","1"
"2020-05-24","HELVECIA","2","18","1","21"
"2020-05-24","HUGHES","0","8","0","8"
"2020-05-24","HUMBERTO PRIMO","0","1","0","1"
"2020-05-24","HUMBOLDT","1","2","0","3"
"2020-05-24","IBARLUCEA","0","11","0","11"
"2020-05-24","JOSEFINA","0","2","0","2"
"2020-05-24","JUAN B. MOLINA","0","1","0","1"
"2020-05-24","JUNCAL","0","2","0","2"
"2020-05-24","LABORDEBOY","0","2","0","2"
"2020-05-24","LA BRAVA","0","1","0","1"
"2020-05-24","LA CAROLINA","0","1","0","1"
"2020-05-24","LA CRIOLLA","0","3","0","3"
"2020-05-24","LAGUNA PAIVA","0","8","0","8"
"2020-05-24","LANDETA","0","2","0","2"
"2020-05-24","LANTERI","0","1","0","1"
"2020-05-24","LAS PAREJAS","1","17","0","18"
"2020-05-24","LAS ROSAS","2","19","0","21"
"2020-05-24","LAS TOSCAS","0","4","0","4"
"2020-05-24","LA VANGUARDIA","0","1","0","1"
"2020-05-24","LEHMANN","0","2","1","3"
"2020-05-24","LLAMBI CAMPBELL","3","3","0","6"
"2020-05-24","LOPEZ","0","2","0","2"
"2020-05-24","LOS MOLINOS","0","1","0","1"
"2020-05-24","LOS QUIRQUINCHOS","0","3","0","3"
"2020-05-24","LUIS PALACIOS","0","4","0","4"
"2020-05-24","MACIEL","0","6","2","8"
"2020-05-24","MAGGIOLO","0","4","0","4"
"2020-05-24","MALABRIGO","0","1","0","1"
"2020-05-24","MARGARITA","0","3","0","3"
"2020-05-24","MARIA JUANA","1","8","0","9"
"2020-05-24","MARIA SUSANA","0","4","0","4"
"2020-05-24","MARIA TERESA","0","2","0","2"
"2020-05-24","MAXIMO PAZ","0","3","0","3"
"2020-05-24","MELINCUE","0","1","0","1"
"2020-05-24","MIGUEL TORRES","0","3","0","3"
"2020-05-24","MONJE","0","2","0","2"
"2020-05-24","MONTEFIORE","0","1","0","1"
"2020-05-24","MONTES DE OCA","0","3","0","3"
"2020-05-24","MONTE VERA","0","13","0","13"
"2020-05-24","MOUSSY","0","1","0","1"
"2020-05-24","MURPHY","0","4","0","4"
"2020-05-24","NELSON","0","4","0","4"
"2020-05-24","NUEVO TORINO","0","1","0","1"
"2020-05-24","OLIVEROS","4","20","1","25"
"2020-05-24","PAVON","0","2","0","2"
"2020-05-24","PAVON ARRIBA","0","1","0","1"
"2020-05-24","PEREZ","0","58","3","61"
"2020-05-24","PIAMONTE","0","2","0","2"
"2020-05-24","PILAR","0","4","0","4"
"2020-05-24","PIÑERO","0","2","0","2"
"2020-05-24","PLAZA CLUCELLAS","0","5","0","5"
"2020-05-24","PRESIDENTE ROCA","0","1","0","1"
"2020-05-24","PROGRESO","0","1","0","1"
"2020-05-24","PUEBLO ANDINO","2","5","0","7"
"2020-05-24","PUEBLO ESTHER","0","25","0","25"
"2020-05-24","PUEBLO IRIGOYEN","0","1","0","1"
"2020-05-24","PUEBLO URANGA","0","1","0","1"
"2020-05-24","PUERTO ARAGON","0","1","0","1"
"2020-05-24","PUERTO GENERAL SAN MARTIN","0","30","1","31"
"2020-05-24","PUERTO RECONQUISTA","0","1","0","1"
"2020-05-24","PUJATO","2","8","0","10"
"2020-05-24","RAFAELA","21","143","4","168"
"2020-05-24","RAMONA","0","2","0","2"
"2020-05-24","RECONQUISTA","0","56","1","57"
"2020-05-24","RECREO","0","24","0","24"
"2020-05-24","RICARDONE","0","9","0","9"
"2020-05-24","RINCON POTRERO","0","1","0","1"
"2020-05-24","ROLDAN","6","52","0","58"
"2020-05-24","ROMANG","0","2","0","2"
"2020-05-24","ROSARIO","112","4221","145","4478"
"2020-05-24","RUFINO","0","32","0","32"
"2020-05-24","SALTO GRANDE","0","2","0","2"
"2020-05-24","SAN ANTONIO DE OBLIGADO","0","1","0","1"
"2020-05-24","SAN CARLOS CENTRO","0","13","1","14"
"2020-05-24","SAN CARLOS SUD","1","2","0","3"
"2020-05-24","SAN CRISTOBAL","0","5","1","6"
"2020-05-24","SANCTI SPIRITU","1","26","0","27"
"2020-05-24","SAN EDUARDO","0","7","1","8"
"2020-05-24","SAN FABIAN","0","0","1","1"
"2020-05-24","SANFORD","0","3","0","3"
"2020-05-24","SAN FRANCISCO DE SANTA FE","0","2","0","2"
"2020-05-24","SAN GENARO","1","4","0","5"
"2020-05-24","SAN GREGORIO","0","5","0","5"
"2020-05-24","SAN GUILLERMO","0","4","0","4"
"2020-05-24","SAN JAVIER","1","11","0","12"
"2020-05-24","SAN JERONIMO DEL SAUCE","0","1","0","1"
"2020-05-24","SAN JERONIMO NORTE","0","3","0","3"
"2020-05-24","SAN JERONIMO SUD","0","4","0","4"
"2020-05-24","SAN JORGE","0","13","1","14"
"2020-05-24","SAN JOSE DE LA ESQUINA","0","10","2","12"
"2020-05-24","SAN JOSE DEL RINCON","1","13","1","15"
"2020-05-24","SAN JUSTO","0","15","0","15"
"2020-05-24","SAN LORENZO","3","111","4","118"
"2020-05-24","SAN MARTIN DE LAS ESCOBAS","0","3","0","3"
"2020-05-24","SAN MARTIN NORTE","0","1","0","1"
"2020-05-24","SANTA CLARA DE BUENA VISTA","0","2","0","2"
"2020-05-24","SANTA FE","27","740","33","800"
"2020-05-24","SANTA ISABEL","0","8","1","9"
"2020-05-24","SANTA ROSA DE CALCHINES","0","5","0","5"
"2020-05-24","SANTO DOMINGO","0","2","0","2"
"2020-05-24","SANTO TOME","5","104","0","109"
"2020-05-24","SAN VICENTE","0","3","0","3"
"2020-05-24","SA PEREYRA","0","1","0","1"
"2020-05-24","SARGENTO CABRAL","0","2","0","2"
"2020-05-24","SARMIENTO","0","2","0","2"
"2020-05-24","SASTRE","0","4","0","4"
"2020-05-24","SAUCE VIEJO","1","21","0","22"
"2020-05-24","SERODINO","0","2","1","3"
"2020-05-24","SOLDINI","0","5","0","5"
"2020-05-24","SUARDI","0","4","0","4"
"2020-05-24","SUNCHALES","0","7","0","7"
"2020-05-24","SUSANA","0","1","0","1"
"2020-05-24","TACURAL","0","3","0","3"
"2020-05-24","TEODELINA","0","8","0","8"
"2020-05-24","TIMBUES","0","6","1","7"
"2020-05-24","TOSTADO","0","5","0","5"
"2020-05-24","TOTORAS","0","6","0","6"
"2020-05-24","VENADO TUERTO","12","228","6","246"
"2020-05-24","VERA","1","21","2","24"
"2020-05-24","VIDELA","0","1","0","1"
"2020-05-24","VILLA AMELIA","0","1","0","1"
"2020-05-24","VILLA ANA","0","3","0","3"
"2020-05-24","VILLA CAÑAS","0","5","0","5"
"2020-05-24","VILLA CONSTITUCION","9","49","0","58"
"2020-05-24","VILLADA","0","1","0","1"
"2020-05-24","VILLA ELOISA","0","2","0","2"
"2020-05-24","VILLA GOBERNADOR GALVEZ","2","203","10","215"
"2020-05-24","VILLA MINETTI","0","4","0","4"
"2020-05-24","VILLA MUGUETA","0","5","0","5"
"2020-05-24","VILLA OCAMPO","0","6","1","7"
"2020-05-24","VILLA TRINIDAD","0","2","0","2"
"2020-05-24","WHEELWRIGHT","0","8","1","9"
"2020-05-24","ZAVALLA","0","4","0","4"
"2020-05-25","ACEBAL","0","5","0","5"
"2020-05-25","ALBARELLOS","0","1","0","1"
"2020-05-25","ALCORTA","0","6","1","7"
"2020-05-25","ALDAO","0","1","0","1"
"2020-05-25","ALVAREZ","0","7","0","7"
"2020-05-25","ALVEAR","0","12","0","12"
"2020-05-25","AMENABAR","0","1","0","1"
"2020-05-25","ANGEL GALLARDO","0","4","0","4"
"2020-05-25","ANGELICA","0","1","0","1"
"2020-05-25","AREQUITO","0","3","0","3"
"2020-05-25","ARMSTRONG","2","17","0","19"
"2020-05-25","AROCENA","0","5","0","5"
"2020-05-25","ARROYO AGUIAR","0","1","0","1"
"2020-05-25","ARROYO LEYES","0","11","0","11"
"2020-05-25","ARROYO SECO","2","38","0","40"
"2020-05-25","ARRUFO","0","2","0","2"
"2020-05-25","ARTEAGA","0","3","1","4"
"2020-05-25","AVELLANEDA","0","19","0","19"
"2020-05-25","BARRANCAS","0","3","0","3"
"2020-05-25","BERAVEBU","0","1","0","1"
"2020-05-25","BERNA","0","1","0","1"
"2020-05-25","BERNARDO DE IRIGOYEN","0","2","0","2"
"2020-05-25","BIGAND","0","17","0","17"
"2020-05-25","BOMBAL","0","7","0","7"
"2020-05-25","BOUQUET","0","1","0","1"
"2020-05-25","BUSTINZA","0","1","0","1"
"2020-05-25","CAFFERATA","0","2","0","2"
"2020-05-25","CALCHAQUI","0","9","1","10"
"2020-05-25","CAÑADA DE GOMEZ","1","47","0","48"
"2020-05-25","CAÑADA DEL UCLE","0","1","0","1"
"2020-05-25","CAPITAN BERMUDEZ","1","63","1","65"
"2020-05-25","CARCARAÑA","0","18","0","18"
"2020-05-25","CARLOS PELLEGRINI","0","9","0","9"
"2020-05-25","CARMEN","0","2","0","2"
"2020-05-25","CARRERAS","0","4","0","4"
"2020-05-25","CARRIZALES","0","2","1","3"
"2020-05-25","CASAS","0","1","0","1"
"2020-05-25","CASILDA","2","55","3","60"
"2020-05-25","CAYASTA","1","4","0","5"
"2020-05-25","CERES","0","19","0","19"
"2020-05-25","CHABAS","1","12","0","13"
"2020-05-25","CHAÑAR LADEADO","0","2","0","2"
"2020-05-25","CHOVET","0","9","0","9"
"2020-05-25","CHRISTOPHERSEN","0","1","0","1"
"2020-05-25","CLASON","0","1","0","1"
"2020-05-25","COLONIA MASCIAS","0","1","0","1"
"2020-05-25","COLONIA ROSA","0","1","0","1"
"2020-05-25","CORONDA","0","11","1","12"
"2020-05-25","CORONEL ARNOLD","0","1","0","1"
"2020-05-25","CORONEL BOGADO","0","2","0","2"
"2020-05-25","CORONEL RODOLFO S. DOMINGUEZ","0","2","0","2"
"2020-05-25","CORREA","0","7","0","7"
"2020-05-25","CULULU","0","1","0","1"
"2020-05-25","DESVIO ARIJON","0","2","1","3"
"2020-05-25","DIAZ","0","1","0","1"
"2020-05-25","DIEGO DE ALVEAR","0","4","0","4"
"2020-05-25","EL ARAZA","0","1","0","1"
"2020-05-25","ELISA","0","1","0","1"
"2020-05-25","ELORTONDO","4","10","0","14"
"2020-05-25","EL RABON","0","2","0","2"
"2020-05-25","EL TREBOL","0","9","0","9"
"2020-05-25","EMPALME VILLA CONSTITUCION","0","9","0","9"
"2020-05-25","ESPERANZA","1","51","0","52"
"2020-05-25","FIGHIERA","0","5","0","5"
"2020-05-25","FIRMAT","1","30","0","31"
"2020-05-25","FLORENCIA","0","3","0","3"
"2020-05-25","FORTIN OLMOS","0","2","0","2"
"2020-05-25","FRANCK","1","9","0","10"
"2020-05-25","FRAY LUIS BELTRAN","4","35","1","40"
"2020-05-25","FRONTERA","0","27","0","27"
"2020-05-25","FUENTES","0","4","0","4"
"2020-05-25","FUNES","5","65","2","72"
"2020-05-25","GABOTO","0","3","1","4"
"2020-05-25","GALVEZ","9","20","0","29"
"2020-05-25","GATO COLORADO","0","1","0","1"
"2020-05-25","GENERAL LAGOS","0","5","0","5"
"2020-05-25","GESSLER","0","1","0","1"
"2020-05-25","GOBERNADOR CRESPO","0","3","0","3"
"2020-05-25","GODEKEN","0","4","0","4"
"2020-05-25","GODOY","0","1","0","1"
"2020-05-25","GRANADERO BAIGORRIA","2","122","0","124"
"2020-05-25","GREGORIA PEREZ DE DENIS","0","1","0","1"
"2020-05-25","HELVECIA","2","18","1","21"
"2020-05-25","HUGHES","0","8","0","8"
"2020-05-25","HUMBERTO PRIMO","0","1","0","1"
"2020-05-25","HUMBOLDT","1","2","0","3"
"2020-05-25","IBARLUCEA","0","11","0","11"
"2020-05-25","JOSEFINA","0","2","0","2"
"2020-05-25","JUAN B. MOLINA","0","1","0","1"
"2020-05-25","JUNCAL","0","2","0","2"
"2020-05-25","LABORDEBOY","0","2","0","2"
"2020-05-25","LA BRAVA","0","1","0","1"
"2020-05-25","LA CAROLINA","0","1","0","1"
"2020-05-25","LA CRIOLLA","0","3","0","3"
"2020-05-25","LAGUNA PAIVA","0","8","0","8"
"2020-05-25","LANDETA","0","2","0","2"
"2020-05-25","LANTERI","0","1","0","1"
"2020-05-25","LAS PAREJAS","1","17","0","18"
"2020-05-25","LAS ROSAS","2","19","0","21"
"2020-05-25","LAS TOSCAS","0","4","0","4"
"2020-05-25","LA VANGUARDIA","0","1","0","1"
"2020-05-25","LEHMANN","0","2","1","3"
"2020-05-25","LLAMBI CAMPBELL","3","3","0","6"
"2020-05-25","LOPEZ","0","2","0","2"
"2020-05-25","LOS MOLINOS","0","1","0","1"
"2020-05-25","LOS QUIRQUINCHOS","0","3","0","3"
"2020-05-25","LUIS PALACIOS","0","4","0","4"
"2020-05-25","MACIEL","0","7","1","8"
"2020-05-25","MAGGIOLO","0","4","0","4"
"2020-05-25","MALABRIGO","0","1","0","1"
"2020-05-25","MARGARITA","0","3","0","3"
"2020-05-25","MARIA JUANA","1","8","0","9"
"2020-05-25","MARIA SUSANA","0","4","0","4"
"2020-05-25","MARIA TERESA","0","2","0","2"
"2020-05-25","MAXIMO PAZ","0","3","0","3"
"2020-05-25","MELINCUE","0","1","0","1"
"2020-05-25","MIGUEL TORRES","0","3","0","3"
"2020-05-25","MONJE","0","2","0","2"
"2020-05-25","MONTEFIORE","0","1","0","1"
"2020-05-25","MONTES DE OCA","0","3","0","3"
"2020-05-25","MONTE VERA","0","13","0","13"
"2020-05-25","MOUSSY","0","1","0","1"
"2020-05-25","MURPHY","0","4","0","4"
"2020-05-25","NELSON","0","4","0","4"
"2020-05-25","NUEVO TORINO","0","1","0","1"
"2020-05-25","OLIVEROS","4","20","1","25"
"2020-05-25","PAVON","0","2","0","2"
"2020-05-25","PAVON ARRIBA","0","1","0","1"
"2020-05-25","PEREZ","0","60","3","63"
"2020-05-25","PIAMONTE","0","2","0","2"
"2020-05-25","PILAR","0","4","0","4"
"2020-05-25","PIÑERO","0","2","0","2"
"2020-05-25","PLAZA CLUCELLAS","0","5","0","5"
"2020-05-25","PRESIDENTE ROCA","0","1","0","1"
"2020-05-25","PROGRESO","0","1","0","1"
"2020-05-25","PUEBLO ANDINO","2","5","0","7"
"2020-05-25","PUEBLO ESTHER","0","25","0","25"
"2020-05-25","PUEBLO IRIGOYEN","0","1","0","1"
"2020-05-25","PUEBLO URANGA","0","1","0","1"
"2020-05-25","PUERTO ARAGON","0","1","0","1"
"2020-05-25","PUERTO GENERAL SAN MARTIN","0","31","2","33"
"2020-05-25","PUERTO RECONQUISTA","0","1","0","1"
"2020-05-25","PUJATO","2","8","0","10"
"2020-05-25","RAFAELA","21","143","4","168"
"2020-05-25","RAMONA","0","2","0","2"
"2020-05-25","RECONQUISTA","0","56","1","57"
"2020-05-25","RECREO","0","24","0","24"
"2020-05-25","RICARDONE","0","9","0","9"
"2020-05-25","RINCON POTRERO","0","1","0","1"
"2020-05-25","ROLDAN","6","53","0","59"
"2020-05-25","ROMANG","0","2","0","2"
"2020-05-25","ROSARIO","112","4311","94","4517"
"2020-05-25","RUFINO","0","32","0","32"
"2020-05-25","SALTO GRANDE","0","2","0","2"
"2020-05-25","SAN ANTONIO DE OBLIGADO","0","1","0","1"
"2020-05-25","SAN CARLOS CENTRO","0","13","1","14"
"2020-05-25","SAN CARLOS SUD","1","2","0","3"
"2020-05-25","SAN CRISTOBAL","0","5","1","6"
"2020-05-25","SANCTI SPIRITU","1","26","0","27"
"2020-05-25","SAN EDUARDO","0","8","0","8"
"2020-05-25","SAN FABIAN","0","0","1","1"
"2020-05-25","SANFORD","0","3","0","3"
"2020-05-25","SAN FRANCISCO DE SANTA FE","0","2","0","2"
"2020-05-25","SAN GENARO","1","4","0","5"
"2020-05-25","SAN GREGORIO","0","5","0","5"
"2020-05-25","SAN GUILLERMO","0","4","0","4"
"2020-05-25","SAN JAVIER","1","11","1","13"
"2020-05-25","SAN JERONIMO DEL SAUCE","0","1","0","1"
"2020-05-25","SAN JERONIMO NORTE","0","3","0","3"
"2020-05-25","SAN JERONIMO SUD","0","4","0","4"
"2020-05-25","SAN JORGE","0","13","1","14"
"2020-05-25","SAN JOSE DE LA ESQUINA","0","10","2","12"
"2020-05-25","SAN JOSE DEL RINCON","1","13","1","15"
"2020-05-25","SAN JUSTO","0","15","0","15"
"2020-05-25","SAN LORENZO","3","112","6","121"
"2020-05-25","SAN MARTIN DE LAS ESCOBAS","0","3","0","3"
"2020-05-25","SAN MARTIN NORTE","0","1","0","1"
"2020-05-25","SANTA CLARA DE BUENA VISTA","0","2","0","2"
"2020-05-25","SANTA FE","27","741","32","800"
"2020-05-25","SANTA ISABEL","0","8","1","9"
"2020-05-25","SANTA ROSA DE CALCHINES","0","5","0","5"
"2020-05-25","SANTO DOMINGO","0","2","0","2"
"2020-05-25","SANTO TOME","5","104","3","112"
"2020-05-25","SAN VICENTE","0","3","0","3"
"2020-05-25","SA PEREYRA","0","1","1","2"
"2020-05-25","SARGENTO CABRAL","0","2","0","2"
"2020-05-25","SARMIENTO","0","2","0","2"
"2020-05-25","SASTRE","0","4","0","4"
"2020-05-25","SAUCE VIEJO","1","21","0","22"
"2020-05-25","SERODINO","0","3","0","3"
"2020-05-25","SOLDINI","0","5","0","5"
"2020-05-25","SUARDI","0","4","0","4"
"2020-05-25","SUNCHALES","0","7","0","7"
"2020-05-25","SUSANA","0","1","0","1"
"2020-05-25","TACURAL","0","3","0","3"
"2020-05-25","TEODELINA","0","8","0","8"
"2020-05-25","TIMBUES","0","6","1","7"
"2020-05-25","TOSTADO","0","5","0","5"
"2020-05-25","TOTORAS","0","6","0","6"
"2020-05-25","VENADO TUERTO","12","229","5","246"
"2020-05-25","VERA","1","21","2","24"
"2020-05-25","VIDELA","0","1","0","1"
"2020-05-25","VILLA AMELIA","0","1","0","1"
"2020-05-25","VILLA ANA","0","3","0","3"
"2020-05-25","VILLA CAÑAS","0","5","0","5"
"2020-05-25","VILLA CONSTITUCION","9","49","0","58"
"2020-05-25","VILLADA","0","1","0","1"
"2020-05-25","VILLA ELOISA","0","2","0","2"
"2020-05-25","VILLA GOBERNADOR GALVEZ","2","208","6","216"
"2020-05-25","VILLA MINETTI","0","4","0","4"
"2020-05-25","VILLA MUGUETA","0","5","0","5"
"2020-05-25","VILLA OCAMPO","0","6","1","7"
"2020-05-25","VILLA TRINIDAD","0","2","0","2"
"2020-05-25","WHEELWRIGHT","0","8","1","9"
"2020-05-25","ZAVALLA","0","4","0","4"
"2020-05-26","ACEBAL","0","5","0","5"
"2020-05-26","ALBARELLOS","0","1","0","1"
"2020-05-26","ALCORTA","0","7","0","7"
"2020-05-26","ALDAO","0","1","0","1"
"2020-05-26","ALVAREZ","0","7","0","7"
"2020-05-26","ALVEAR","0","12","0","12"
"2020-05-26","AMENABAR","0","1","0","1"
"2020-05-26","ANGEL GALLARDO","0","4","0","4"
"2020-05-26","ANGELICA","0","1","0","1"
"2020-05-26","AREQUITO","0","3","0","3"
"2020-05-26","ARMSTRONG","2","17","0","19"
"2020-05-26","AROCENA","0","5","0","5"
"2020-05-26","ARROYO AGUIAR","0","1","0","1"
"2020-05-26","ARROYO LEYES","0","11","0","11"
"2020-05-26","ARROYO SECO","2","39","2","43"
"2020-05-26","ARRUFO","0","2","0","2"
"2020-05-26","ARTEAGA","0","4","0","4"
"2020-05-26","AVELLANEDA","0","19","0","19"
"2020-05-26","BARRANCAS","0","3","0","3"
"2020-05-26","BERAVEBU","0","1","0","1"
"2020-05-26","BERNA","0","1","0","1"
"2020-05-26","BERNARDO DE IRIGOYEN","0","2","0","2"
"2020-05-26","BIGAND","0","18","0","18"
"2020-05-26","BOMBAL","0","7","0","7"
"2020-05-26","BOUQUET","0","1","0","1"
"2020-05-26","BUSTINZA","0","1","0","1"
"2020-05-26","CAFFERATA","0","2","0","2"
"2020-05-26","CALCHAQUI","0","10","0","10"
"2020-05-26","CAÑADA DE GOMEZ","1","48","1","50"
"2020-05-26","CAÑADA DEL UCLE","0","1","0","1"
"2020-05-26","CAPITAN BERMUDEZ","1","64","1","66"
"2020-05-26","CARCARAÑA","0","20","0","20"
"2020-05-26","CARLOS PELLEGRINI","0","9","0","9"
"2020-05-26","CARMEN","0","2","1","3"
"2020-05-26","CARRERAS","0","4","0","4"
"2020-05-26","CARRIZALES","0","3","0","3"
"2020-05-26","CASAS","0","1","0","1"
"2020-05-26","CASILDA","2","56","4","62"
"2020-05-26","CAYASTA","1","4","0","5"
"2020-05-26","CENTENO","0","1","0","1"
"2020-05-26","CERES","0","19","0","19"
"2020-05-26","CHABAS","1","12","0","13"
"2020-05-26","CHAÑAR LADEADO","0","2","0","2"
"2020-05-26","CHOVET","0","9","0","9"
"2020-05-26","CHRISTOPHERSEN","0","1","0","1"
"2020-05-26","CLASON","0","1","0","1"
"2020-05-26","COLONIA MASCIAS","0","1","0","1"
"2020-05-26","COLONIA ROSA","0","1","0","1"
"2020-05-26","CORONDA","0","11","2","13"
"2020-05-26","CORONEL ARNOLD","0","1","1","2"
"2020-05-26","CORONEL BOGADO","0","2","0","2"
"2020-05-26","CORONEL RODOLFO S. DOMINGUEZ","0","2","0","2"
"2020-05-26","CORREA","0","7","0","7"
"2020-05-26","CULULU","0","1","0","1"
"2020-05-26","DESVIO ARIJON","0","3","0","3"
"2020-05-26","DIAZ","0","1","0","1"
"2020-05-26","DIEGO DE ALVEAR","0","4","0","4"
"2020-05-26","EL ARAZA","0","1","0","1"
"2020-05-26","ELISA","0","1","0","1"
"2020-05-26","ELORTONDO","4","10","0","14"
"2020-05-26","EL RABON","0","2","0","2"
"2020-05-26","EL TREBOL","0","9","0","9"
"2020-05-26","EMPALME VILLA CONSTITUCION","0","9","0","9"
"2020-05-26","ESPERANZA","1","51","1","53"
"2020-05-26","FIGHIERA","0","5","0","5"
"2020-05-26","FIRMAT","1","32","0","33"
"2020-05-26","FLORENCIA","0","3","0","3"
"2020-05-26","FORTIN OLMOS","0","2","0","2"
"2020-05-26","FRANCK","1","9","0","10"
"2020-05-26","FRAY LUIS BELTRAN","4","36","0","40"
"2020-05-26","FRONTERA","0","27","0","27"
"2020-05-26","FUENTES","0","4","0","4"
"2020-05-26","FUNES","5","69","3","77"
"2020-05-26","GABOTO","0","3","1","4"
"2020-05-26","GALVEZ","9","21","0","30"
"2020-05-26","GATO COLORADO","0","1","0","1"
"2020-05-26","GENERAL LAGOS","0","5","0","5"
"2020-05-26","GESSLER","0","1","0","1"
"2020-05-26","GOBERNADOR CRESPO","0","3","1","4"
"2020-05-26","GODEKEN","0","4","0","4"
"2020-05-26","GODOY","0","1","0","1"
"2020-05-26","GRANADERO BAIGORRIA","2","122","0","124"
"2020-05-26","GREGORIA PEREZ DE DENIS","0","1","0","1"
"2020-05-26","HELVECIA","2","18","1","21"
"2020-05-26","HUGHES","0","8","0","8"
"2020-05-26","HUMBERTO PRIMO","0","1","0","1"
"2020-05-26","HUMBOLDT","1","2","0","3"
"2020-05-26","IBARLUCEA","0","11","0","11"
"2020-05-26","JOSEFINA","0","2","1","3"
"2020-05-26","JUAN B. MOLINA","0","1","0","1"
"2020-05-26","JUNCAL","0","2","0","2"
"2020-05-26","LABORDEBOY","0","2","0","2"
"2020-05-26","LA BRAVA","0","1","0","1"
"2020-05-26","LA CAROLINA","0","1","0","1"
"2020-05-26","LA CRIOLLA","0","3","0","3"
"2020-05-26","LAGUNA PAIVA","0","8","0","8"
"2020-05-26","LANDETA","0","2","0","2"
"2020-05-26","LANTERI","0","1","0","1"
"2020-05-26","LAS PAREJAS","1","17","1","19"
"2020-05-26","LAS ROSAS","2","19","0","21"
"2020-05-26","LAS TOSCAS","0","4","0","4"
"2020-05-26","LA VANGUARDIA","0","1","0","1"
"2020-05-26","LEHMANN","0","3","0","3"
"2020-05-26","LLAMBI CAMPBELL","3","3","0","6"
"2020-05-26","LOPEZ","0","2","0","2"
"2020-05-26","LOS MOLINOS","0","1","0","1"
"2020-05-26","LOS QUIRQUINCHOS","0","3","0","3"
"2020-05-26","LUIS PALACIOS","0","4","0","4"
"2020-05-26","MACIEL","0","8","1","9"
"2020-05-26","MAGGIOLO","0","4","0","4"
"2020-05-26","MALABRIGO","0","1","0","1"
"2020-05-26","MARGARITA","0","3","0","3"
"2020-05-26","MARIA JUANA","1","8","0","9"
"2020-05-26","MARIA SUSANA","0","4","0","4"
"2020-05-26","MARIA TERESA","0","2","0","2"
"2020-05-26","MAXIMO PAZ","0","3","0","3"
"2020-05-26","MELINCUE","0","1","0","1"
"2020-05-26","MIGUEL TORRES","0","3","0","3"
"2020-05-26","MONJE","0","2","0","2"
"2020-05-26","MONTEFIORE","0","1","0","1"
"2020-05-26","MONTES DE OCA","0","3","0","3"
"2020-05-26","MONTE VERA","0","13","0","13"
"2020-05-26","MOUSSY","0","1","0","1"
"2020-05-26","MURPHY","0","5","0","5"
"2020-05-26","NELSON","0","4","0","4"
"2020-05-26","NUEVO TORINO","0","1","0","1"
"2020-05-26","OLIVEROS","4","21","1","26"
"2020-05-26","PAVON","0","2","0","2"
"2020-05-26","PAVON ARRIBA","0","1","0","1"
"2020-05-26","PEREZ","0","62","2","64"
"2020-05-26","PIAMONTE","0","2","0","2"
"2020-05-26","PILAR","0","4","2","6"
"2020-05-26","PIÑERO","0","2","0","2"
"2020-05-26","PLAZA CLUCELLAS","0","5","0","5"
"2020-05-26","PRESIDENTE ROCA","0","1","0","1"
"2020-05-26","PROGRESO","0","1","0","1"
"2020-05-26","PUEBLO ANDINO","2","5","0","7"
"2020-05-26","PUEBLO ESTHER","0","25","0","25"
"2020-05-26","PUEBLO IRIGOYEN","0","1","0","1"
"2020-05-26","PUEBLO URANGA","0","1","0","1"
"2020-05-26","PUERTO ARAGON","0","1","0","1"
"2020-05-26","PUERTO GENERAL SAN MARTIN","0","34","0","34"
"2020-05-26","PUERTO RECONQUISTA","0","1","0","1"
"2020-05-26","PUJATO","2","8","0","10"
"2020-05-26","RAFAELA","21","143","6","170"
"2020-05-26","RAMONA","0","2","0","2"
"2020-05-26","RECONQUISTA","0","56","2","58"
"2020-05-26","RECREO","0","24","0","24"
"2020-05-26","RICARDONE","0","9","0","9"
"2020-05-26","RINCON POTRERO","0","1","0","1"
"2020-05-26","ROLDAN","6","54","0","60"
"2020-05-26","ROMANG","0","2","0","2"
"2020-05-26","ROSARIO","113","4388","96","4597"
"2020-05-26","RUFINO","0","32","0","32"
"2020-05-26","SALTO GRANDE","0","2","0","2"
"2020-05-26","SAN ANTONIO DE OBLIGADO","0","1","0","1"
"2020-05-26","SAN CARLOS CENTRO","0","14","0","14"
"2020-05-26","SAN CARLOS SUD","1","2","0","3"
"2020-05-26","SAN CRISTOBAL","0","6","0","6"
"2020-05-26","SANCTI SPIRITU","1","26","0","27"
"2020-05-26","SAN EDUARDO","0","8","0","8"
"2020-05-26","SAN FABIAN","0","1","0","1"
"2020-05-26","SANFORD","0","3","0","3"
"2020-05-26","SAN FRANCISCO DE SANTA FE","0","2","0","2"
"2020-05-26","SAN GENARO","1","4","0","5"
"2020-05-26","SAN GREGORIO","0","5","0","5"
"2020-05-26","SAN GUILLERMO","0","4","0","4"
"2020-05-26","SAN JAVIER","1","11","1","13"
"2020-05-26","SAN JERONIMO DEL SAUCE","0","1","0","1"
"2020-05-26","SAN JERONIMO NORTE","0","3","0","3"
"2020-05-26","SAN JERONIMO SUD","0","4","0","4"
"2020-05-26","SAN JORGE","0","13","1","14"
"2020-05-26","SAN JOSE DE LA ESQUINA","0","10","2","12"
"2020-05-26","SAN JOSE DEL RINCON","1","13","1","15"
"2020-05-26","SAN JUSTO","0","15","0","15"
"2020-05-26","SAN LORENZO","3","115","6","124"
"2020-05-26","SAN MARTIN DE LAS ESCOBAS","0","3","0","3"
"2020-05-26","SAN MARTIN NORTE","0","1","0","1"
"2020-05-26","SANTA CLARA DE BUENA VISTA","0","2","0","2"
"2020-05-26","SANTA FE","27","750","43","820"
"2020-05-26","SANTA ISABEL","0","8","1","9"
"2020-05-26","SANTA ROSA DE CALCHINES","0","5","0","5"
"2020-05-26","SANTO DOMINGO","0","2","0","2"
"2020-05-26","SANTO TOME","5","107","1","113"
"2020-05-26","SAN VICENTE","0","3","0","3"
"2020-05-26","SA PEREYRA","0","2","0","2"
"2020-05-26","SARGENTO CABRAL","0","2","0","2"
"2020-05-26","SARMIENTO","0","2","0","2"
"2020-05-26","SASTRE","0","4","0","4"
"2020-05-26","SAUCE VIEJO","1","21","0","22"
"2020-05-26","SERODINO","0","3","0","3"
"2020-05-26","SOLDINI","0","5","0","5"
"2020-05-26","SUARDI","0","4","0","4"
"2020-05-26","SUNCHALES","0","7","0","7"
"2020-05-26","SUSANA","0","1","0","1"
"2020-05-26","TACURAL","0","3","0","3"
"2020-05-26","TEODELINA","0","8","0","8"
"2020-05-26","TIMBUES","0","6","1","7"
"2020-05-26","TOSTADO","0","5","0","5"
"2020-05-26","TOTORAS","0","6","0","6"
"2020-05-26","VENADO TUERTO","12","231","5","248"
"2020-05-26","VERA","1","23","0","24"
"2020-05-26","VIDELA","0","1","0","1"
"2020-05-26","VILLA AMELIA","0","1","0","1"
"2020-05-26","VILLA ANA","0","3","0","3"
"2020-05-26","VILLA CAÑAS","0","5","0","5"
"2020-05-26","VILLA CONSTITUCION","9","49","0","58"
"2020-05-26","VILLADA","0","1","0","1"
"2020-05-26","VILLA ELOISA","0","2","0","2"
"2020-05-26","VILLA GOBERNADOR GALVEZ","2","210","7","219"
"2020-05-26","VILLA MINETTI","0","4","1","5"
"2020-05-26","VILLA MUGUETA","0","5","0","5"
"2020-05-26","VILLA OCAMPO","0","6","1","7"
"2020-05-26","VILLA TRINIDAD","0","2","0","2"
"2020-05-26","WHEELWRIGHT","0","8","2","10"
"2020-05-26","ZAVALLA","0","4","0","4"
"2020-05-27","ACEBAL","0","5","0","5"
"2020-05-27","ALBARELLOS","0","1","0","1"
"2020-05-27","ALCORTA","0","7","0","7"
"2020-05-27","ALDAO","0","1","0","1"
"2020-05-27","ALVAREZ","0","7","1","8"
"2020-05-27","ALVEAR","0","12","0","12"
"2020-05-27","AMENABAR","0","1","0","1"
"2020-05-27","ANGEL GALLARDO","0","4","2","6"
"2020-05-27","ANGELICA","0","1","0","1"
"2020-05-27","AREQUITO","0","3","1","4"
"2020-05-27","ARMSTRONG","2","17","0","19"
"2020-05-27","AROCENA","0","5","0","5"
"2020-05-27","ARROYO AGUIAR","0","1","0","1"
"2020-05-27","ARROYO LEYES","0","11","0","11"
"2020-05-27","ARROYO SECO","2","41","0","43"
"2020-05-27","ARRUFO","0","2","0","2"
"2020-05-27","ARTEAGA","0","4","0","4"
"2020-05-27","AVELLANEDA","0","19","0","19"
"2020-05-27","BARRANCAS","0","3","0","3"
"2020-05-27","BERAVEBU","0","1","0","1"
"2020-05-27","BERNA","0","1","0","1"
"2020-05-27","BERNARDO DE IRIGOYEN","0","2","0","2"
"2020-05-27","BIGAND","0","18","0","18"
"2020-05-27","BOMBAL","0","7","0","7"
"2020-05-27","BOUQUET","0","1","0","1"
"2020-05-27","BUSTINZA","0","1","0","1"
"2020-05-27","CAFFERATA","0","2","0","2"
"2020-05-27","CALCHAQUI","0","10","0","10"
"2020-05-27","CAÑADA DE GOMEZ","1","49","1","51"
"2020-05-27","CAÑADA DEL UCLE","0","1","0","1"
"2020-05-27","CAPITAN BERMUDEZ","1","64","1","66"
"2020-05-27","CARCARAÑA","0","20","0","20"
"2020-05-27","CARLOS PELLEGRINI","0","9","0","9"
"2020-05-27","CARMEN","0","3","0","3"
"2020-05-27","CARRERAS","0","4","1","5"
"2020-05-27","CARRIZALES","0","3","0","3"
"2020-05-27","CASAS","0","1","0","1"
"2020-05-27","CASILDA","2","59","3","64"
"2020-05-27","CAYASTA","1","4","0","5"
"2020-05-27","CENTENO","0","1","0","1"
"2020-05-27","CERES","0","19","0","19"
"2020-05-27","CHABAS","1","12","0","13"
"2020-05-27","CHAÑAR LADEADO","0","2","0","2"
"2020-05-27","CHOVET","0","10","0","10"
"2020-05-27","CHRISTOPHERSEN","0","1","0","1"
"2020-05-27","CLASON","0","1","0","1"
"2020-05-27","COLONIA MASCIAS","0","1","0","1"
"2020-05-27","COLONIA ROSA","0","1","0","1"
"2020-05-27","CORONDA","0","12","1","13"
"2020-05-27","CORONEL ARNOLD","0","2","0","2"
"2020-05-27","CORONEL BOGADO","0","2","0","2"
"2020-05-27","CORONEL RODOLFO S. DOMINGUEZ","0","2","0","2"
"2020-05-27","CORREA","0","7","0","7"
"2020-05-27","CULULU","0","1","0","1"
"2020-05-27","DESVIO ARIJON","0","3","0","3"
"2020-05-27","DIAZ","0","1","0","1"
"2020-05-27","DIEGO DE ALVEAR","0","4","0","4"
"2020-05-27","EL ARAZA","0","1","0","1"
"2020-05-27","ELISA","0","1","0","1"
"2020-05-27","ELORTONDO","4","11","0","15"
"2020-05-27","EL RABON","0","2","0","2"
"2020-05-27","EL TREBOL","0","9","0","9"
"2020-05-27","EMPALME VILLA CONSTITUCION","0","9","0","9"
"2020-05-27","ESPERANZA","1","51","4","56"
"2020-05-27","FELICIA","0","0","1","1"
"2020-05-27","FIGHIERA","0","5","0","5"
"2020-05-27","FIRMAT","1","34","0","35"
"2020-05-27","FLORENCIA","0","3","0","3"
"2020-05-27","FORTIN OLMOS","0","2","0","2"
"2020-05-27","FRANCK","1","9","0","10"
"2020-05-27","FRAY LUIS BELTRAN","4","36","1","41"
"2020-05-27","FRONTERA","0","27","0","27"
"2020-05-27","FUENTES","0","4","0","4"
"2020-05-27","FUNES","5","72","4","81"
"2020-05-27","GABOTO","0","3","1","4"
"2020-05-27","GALVEZ","9","21","0","30"
"2020-05-27","GATO COLORADO","0","1","0","1"
"2020-05-27","GENERAL LAGOS","0","5","0","5"
"2020-05-27","GESSLER","0","1","0","1"
"2020-05-27","GOBERNADOR CRESPO","0","3","1","4"
"2020-05-27","GODEKEN","0","4","0","4"
"2020-05-27","GODOY","0","1","0","1"
"2020-05-27","GRANADERO BAIGORRIA","2","123","2","127"
"2020-05-27","GREGORIA PEREZ DE DENIS","0","1","0","1"
"2020-05-27","HELVECIA","2","18","1","21"
"2020-05-27","HUGHES","0","8","0","8"
"2020-05-27","HUMBERTO PRIMO","0","1","0","1"
"2020-05-27","HUMBOLDT","1","2","0","3"
"2020-05-27","IBARLUCEA","0","11","0","11"
"2020-05-27","JOSEFINA","0","3","0","3"
"2020-05-27","JUAN B. MOLINA","0","1","0","1"
"2020-05-27","JUNCAL","0","2","0","2"
"2020-05-27","LABORDEBOY","0","2","0","2"
"2020-05-27","LA BRAVA","0","1","0","1"
"2020-05-27","LA CAROLINA","0","1","0","1"
"2020-05-27","LA CRIOLLA","0","3","0","3"
"2020-05-27","LAGUNA PAIVA","0","8","0","8"
"2020-05-27","LANDETA","0","2","0","2"
"2020-05-27","LANTERI","0","1","0","1"
"2020-05-27","LAS PAREJAS","1","19","0","20"
"2020-05-27","LAS ROSAS","2","19","0","21"
"2020-05-27","LAS TOSCAS","0","4","0","4"
"2020-05-27","LA VANGUARDIA","0","1","0","1"
"2020-05-27","LEHMANN","0","3","0","3"
"2020-05-27","LLAMBI CAMPBELL","3","3","0","6"
"2020-05-27","LOPEZ","0","2","0","2"
"2020-05-27","LOS MOLINOS","0","1","0","1"
"2020-05-27","LOS QUIRQUINCHOS","0","3","0","3"
"2020-05-27","LUIS PALACIOS","0","4","0","4"
"2020-05-27","MACIEL","0","8","1","9"
"2020-05-27","MAGGIOLO","0","4","0","4"
"2020-05-27","MALABRIGO","0","1","0","1"
"2020-05-27","MARGARITA","0","3","0","3"
"2020-05-27","MARIA JUANA","1","8","0","9"
"2020-05-27","MARIA SUSANA","0","4","0","4"
"2020-05-27","MARIA TERESA","0","2","0","2"
"2020-05-27","MAXIMO PAZ","0","3","0","3"
"2020-05-27","MELINCUE","0","1","0","1"
"2020-05-27","MIGUEL TORRES","0","3","0","3"
"2020-05-27","MONJE","0","2","0","2"
"2020-05-27","MONTEFIORE","0","1","0","1"
"2020-05-27","MONTES DE OCA","0","3","0","3"
"2020-05-27","MONTE VERA","0","13","0","13"
"2020-05-27","MOUSSY","0","1","0","1"
"2020-05-27","MURPHY","0","5","0","5"
"2020-05-27","NELSON","0","4","0","4"
"2020-05-27","NUEVO TORINO","0","1","0","1"
"2020-05-27","OLIVEROS","4","21","1","26"
"2020-05-27","PAVON","0","2","0","2"
"2020-05-27","PAVON ARRIBA","0","1","0","1"
"2020-05-27","PEREZ","0","63","3","66"
"2020-05-27","PIAMONTE","0","2","0","2"
"2020-05-27","PILAR","0","4","2","6"
"2020-05-27","PIÑERO","0","2","0","2"
"2020-05-27","PLAZA CLUCELLAS","0","5","0","5"
"2020-05-27","PRESIDENTE ROCA","0","1","0","1"
"2020-05-27","PROGRESO","0","1","0","1"
"2020-05-27","PUEBLO ANDINO","2","5","0","7"
"2020-05-27","PUEBLO ESTHER","0","25","0","25"
"2020-05-27","PUEBLO IRIGOYEN","0","1","0","1"
"2020-05-27","PUEBLO URANGA","0","1","0","1"
"2020-05-27","PUERTO ARAGON","0","1","0","1"
"2020-05-27","PUERTO GENERAL SAN MARTIN","0","34","0","34"
"2020-05-27","PUERTO RECONQUISTA","0","1","0","1"
"2020-05-27","PUJATO","2","8","0","10"
"2020-05-27","RAFAELA","21","144","35","200"
"2020-05-27","RAMONA","0","2","0","2"
"2020-05-27","RECONQUISTA","0","57","4","61"
"2020-05-27","RECREO","0","24","1","25"
"2020-05-27","RICARDONE","0","9","0","9"
"2020-05-27","RINCON POTRERO","0","1","0","1"
"2020-05-27","ROLDAN","6","55","0","61"
"2020-05-27","ROMANG","0","2","1","3"
"2020-05-27","ROSARIO","113","4484","65","4662"
"2020-05-27","RUFINO","0","32","1","33"
"2020-05-27","SALTO GRANDE","0","2","0","2"
"2020-05-27","SAN ANTONIO DE OBLIGADO","0","1","0","1"
"2020-05-27","SAN CARLOS CENTRO","0","14","0","14"
"2020-05-27","SAN CARLOS SUD","1","2","0","3"
"2020-05-27","SAN CRISTOBAL","0","6","0","6"
"2020-05-27","SANCTI SPIRITU","1","26","0","27"
"2020-05-27","SAN EDUARDO","0","8","0","8"
"2020-05-27","SAN FABIAN","0","1","0","1"
"2020-05-27","SANFORD","0","3","0","3"
"2020-05-27","SAN FRANCISCO DE SANTA FE","0","2","0","2"
"2020-05-27","SAN GENARO","1","4","1","6"
"2020-05-27","SAN GREGORIO","0","5","0","5"
"2020-05-27","SAN GUILLERMO","0","4","0","4"
"2020-05-27","SAN JAVIER","1","11","1","13"
"2020-05-27","SAN JERONIMO DEL SAUCE","0","1","0","1"
"2020-05-27","SAN JERONIMO NORTE","0","3","0","3"
"2020-05-27","SAN JERONIMO SUD","0","4","0","4"
"2020-05-27","SAN JORGE","0","13","1","14"
"2020-05-27","SAN JOSE DE LA ESQUINA","0","10","3","13"
"2020-05-27","SAN JOSE DEL RINCON","1","13","1","15"
"2020-05-27","SAN JUSTO","0","15","0","15"
"2020-05-27","SAN LORENZO","3","119","5","127"
"2020-05-27","SAN MARTIN DE LAS ESCOBAS","0","3","0","3"
"2020-05-27","SAN MARTIN NORTE","0","1","0","1"
"2020-05-27","SANTA CLARA DE BUENA VISTA","0","2","0","2"
"2020-05-27","SANTA FE","27","756","61","844"
"2020-05-27","SANTA ISABEL","0","8","1","9"
"2020-05-27","SANTA ROSA DE CALCHINES","0","5","0","5"
"2020-05-27","SANTO DOMINGO","0","2","0","2"
"2020-05-27","SANTO TOME","5","107","2","114"
"2020-05-27","SAN VICENTE","0","3","0","3"
"2020-05-27","SA PEREYRA","0","2","0","2"
"2020-05-27","SARGENTO CABRAL","0","2","0","2"
"2020-05-27","SARMIENTO","0","2","0","2"
"2020-05-27","SASTRE","0","4","0","4"
"2020-05-27","SAUCE VIEJO","1","21","0","22"
"2020-05-27","SERODINO","0","3","0","3"
"2020-05-27","SOLDINI","0","5","0","5"
"2020-05-27","SUARDI","0","4","0","4"
"2020-05-27","SUNCHALES","0","9","1","10"
"2020-05-27","SUSANA","0","1","0","1"
"2020-05-27","TACURAL","0","3","0","3"
"2020-05-27","TEODELINA","0","8","0","8"
"2020-05-27","TIMBUES","0","13","1","14"
"2020-05-27","TOSTADO","0","6","0","6"
"2020-05-27","TOTORAS","0","6","0","6"
"2020-05-27","VENADO TUERTO","12","235","5","252"
"2020-05-27","VERA","1","23","2","26"
"2020-05-27","VIDELA","0","1","0","1"
"2020-05-27","VILLA AMELIA","0","1","0","1"
"2020-05-27","VILLA ANA","0","3","0","3"
"2020-05-27","VILLA CAÑAS","0","5","0","5"
"2020-05-27","VILLA CONSTITUCION","9","49","1","59"
"2020-05-27","VILLADA","0","1","0","1"
"2020-05-27","VILLA ELOISA","0","2","0","2"
"2020-05-27","VILLA GOBERNADOR GALVEZ","2","212","9","223"
"2020-05-27","VILLA MINETTI","0","5","0","5"
"2020-05-27","VILLA MUGUETA","0","5","0","5"
"2020-05-27","VILLA OCAMPO","0","6","1","7"
"2020-05-27","VILLA TRINIDAD","0","2","0","2"
"2020-05-27","WHEELWRIGHT","0","9","1","10"
"2020-05-27","ZAVALLA","0","4","0","4"
"2020-05-28","ACEBAL","0","5","0","5"
"2020-05-28","ALBARELLOS","0","1","0","1"
"2020-05-28","ALCORTA","0","7","0","7"
"2020-05-28","ALDAO","0","1","0","1"
"2020-05-28","ALVAREZ","0","8","0","8"
"2020-05-28","ALVEAR","0","12","0","12"
"2020-05-28","AMENABAR","0","1","0","1"
"2020-05-28","ANGEL GALLARDO","0","4","2","6"
"2020-05-28","ANGELICA","0","1","0","1"
"2020-05-28","AREQUITO","0","4","0","4"
"2020-05-28","ARMSTRONG","2","17","0","19"
"2020-05-28","AROCENA","0","5","0","5"
"2020-05-28","ARROYO AGUIAR","0","1","0","1"
"2020-05-28","ARROYO LEYES","0","11","0","11"
"2020-05-28","ARROYO SECO","2","41","1","44"
"2020-05-28","ARRUFO","0","2","0","2"
"2020-05-28","ARTEAGA","0","4","0","4"
"2020-05-28","AVELLANEDA","0","19","0","19"
"2020-05-28","BARRANCAS","0","3","0","3"
"2020-05-28","BERAVEBU","0","1","0","1"
"2020-05-28","BERNA","0","1","0","1"
"2020-05-28","BERNARDO DE IRIGOYEN","0","2","0","2"
"2020-05-28","BIGAND","0","18","0","18"
"2020-05-28","BOMBAL","0","7","0","7"
"2020-05-28","BOUQUET","0","1","0","1"
"2020-05-28","BUSTINZA","0","1","0","1"
"2020-05-28","CAFFERATA","0","2","0","2"
"2020-05-28","CALCHAQUI","0","10","0","10"
"2020-05-28","CAÑADA DE GOMEZ","1","50","0","51"
"2020-05-28","CAÑADA DEL UCLE","0","1","0","1"
"2020-05-28","CAPITAN BERMUDEZ","1","64","1","66"
"2020-05-28","CARCARAÑA","0","20","0","20"
"2020-05-28","CARLOS PELLEGRINI","0","9","0","9"
"2020-05-28","CARMEN","0","3","0","3"
"2020-05-28","CARRERAS","0","5","0","5"
"2020-05-28","CARRIZALES","0","3","0","3"
"2020-05-28","CASAS","0","1","0","1"
"2020-05-28","CASILDA","2","61","1","64"
"2020-05-28","CAYASTA","1","4","0","5"
"2020-05-28","CENTENO","0","1","0","1"
"2020-05-28","CERES","0","19","0","19"
"2020-05-28","CHABAS","1","12","1","14"
"2020-05-28","CHAÑAR LADEADO","0","2","0","2"
"2020-05-28","CHOVET","0","10","0","10"
"2020-05-28","CHRISTOPHERSEN","0","1","0","1"
"2020-05-28","CLASON","0","1","0","1"
"2020-05-28","COLONIA MASCIAS","0","1","0","1"
"2020-05-28","COLONIA ROSA","0","1","0","1"
"2020-05-28","CORONDA","0","13","0","13"
"2020-05-28","CORONEL ARNOLD","0","2","0","2"
"2020-05-28","CORONEL BOGADO","0","2","0","2"
"2020-05-28","CORONEL RODOLFO S. DOMINGUEZ","0","2","0","2"
"2020-05-28","CORREA","0","7","0","7"
"2020-05-28","CULULU","0","1","0","1"
"2020-05-28","DESVIO ARIJON","0","3","0","3"
"2020-05-28","DIAZ","0","1","0","1"
"2020-05-28","DIEGO DE ALVEAR","0","4","0","4"
"2020-05-28","EL ARAZA","0","1","0","1"
"2020-05-28","ELISA","0","1","0","1"
"2020-05-28","ELORTONDO","4","11","0","15"
"2020-05-28","EL RABON","0","2","0","2"
"2020-05-28","EL TREBOL","0","9","0","9"
"2020-05-28","EMPALME VILLA CONSTITUCION","0","9","0","9"
"2020-05-28","ESPERANZA","1","52","4","57"
"2020-05-28","FELICIA","0","0","1","1"
"2020-05-28","FIGHIERA","0","5","0","5"
"2020-05-28","FIRMAT","1","34","0","35"
"2020-05-28","FLORENCIA","0","3","0","3"
"2020-05-28","FORTIN OLMOS","0","3","0","3"
"2020-05-28","FRANCK","1","9","0","10"
"2020-05-28","FRAY LUIS BELTRAN","4","37","1","42"
"2020-05-28","FRONTERA","0","27","0","27"
"2020-05-28","FUENTES","0","4","0","4"
"2020-05-28","FUNES","5","76","2","83"
"2020-05-28","GABOTO","0","3","1","4"
"2020-05-28","GALVEZ","9","21","0","30"
"2020-05-28","GATO COLORADO","0","1","0","1"
"2020-05-28","GENERAL LAGOS","0","5","1","6"
"2020-05-28","GESSLER","0","1","0","1"
"2020-05-28","GOBERNADOR CRESPO","0","4","0","4"
"2020-05-28","GODEKEN","0","4","0","4"
"2020-05-28","GODOY","0","1","0","1"
"2020-05-28","GRANADERO BAIGORRIA","2","125","1","128"
"2020-05-28","GREGORIA PEREZ DE DENIS","0","1","0","1"
"2020-05-28","GRUTLY","0","0","1","1"
"2020-05-28","HELVECIA","2","18","1","21"
"2020-05-28","HUGHES","0","8","0","8"
"2020-05-28","HUMBERTO PRIMO","0","1","0","1"
"2020-05-28","HUMBOLDT","1","2","0","3"
"2020-05-28","IBARLUCEA","0","11","0","11"
"2020-05-28","JOSEFINA","0","3","0","3"
"2020-05-28","JUAN B. MOLINA","0","1","0","1"
"2020-05-28","JUNCAL","0","2","0","2"
"2020-05-28","LABORDEBOY","0","2","0","2"
"2020-05-28","LA BRAVA","0","1","0","1"
"2020-05-28","LA CAROLINA","0","1","0","1"
"2020-05-28","LA CRIOLLA","0","3","0","3"
"2020-05-28","LAGUNA PAIVA","0","8","0","8"
"2020-05-28","LANDETA","0","2","0","2"
"2020-05-28","LANTERI","0","1","0","1"
"2020-05-28","LAS PAREJAS","1","19","0","20"
"2020-05-28","LAS ROSAS","2","20","0","22"
"2020-05-28","LAS TOSCAS","0","4","0","4"
"2020-05-28","LA VANGUARDIA","0","1","0","1"
"2020-05-28","LEHMANN","0","3","0","3"
"2020-05-28","LLAMBI CAMPBELL","3","3","0","6"
"2020-05-28","LOPEZ","0","2","0","2"
"2020-05-28","LOS MOLINOS","0","1","0","1"
"2020-05-28","LOS QUIRQUINCHOS","0","3","0","3"
"2020-05-28","LUIS PALACIOS","0","4","0","4"
"2020-05-28","MACIEL","0","8","1","9"
"2020-05-28","MAGGIOLO","0","4","0","4"
"2020-05-28","MALABRIGO","0","1","0","1"
"2020-05-28","MARGARITA","0","3","0","3"
"2020-05-28","MARIA JUANA","1","8","0","9"
"2020-05-28","MARIA SUSANA","0","4","0","4"
"2020-05-28","MARIA TERESA","0","2","0","2"
"2020-05-28","MAXIMO PAZ","0","3","0","3"
"2020-05-28","MELINCUE","0","1","0","1"
"2020-05-28","MIGUEL TORRES","0","3","0","3"
"2020-05-28","MONJE","0","2","0","2"
"2020-05-28","MONTEFIORE","0","1","0","1"
"2020-05-28","MONTES DE OCA","0","3","1","4"
"2020-05-28","MONTE VERA","0","13","0","13"
"2020-05-28","MOUSSY","0","1","0","1"
"2020-05-28","MURPHY","0","5","0","5"
"2020-05-28","NELSON","0","4","0","4"
"2020-05-28","NUEVO TORINO","0","1","0","1"
"2020-05-28","OLIVEROS","4","21","2","27"
"2020-05-28","PAVON","0","2","0","2"
"2020-05-28","PAVON ARRIBA","0","1","0","1"
"2020-05-28","PEREZ","0","64","2","66"
"2020-05-28","PIAMONTE","0","2","0","2"
"2020-05-28","PILAR","0","5","1","6"
"2020-05-28","PIÑERO","0","2","0","2"
"2020-05-28","PLAZA CLUCELLAS","0","5","0","5"
"2020-05-28","PRESIDENTE ROCA","0","1","0","1"
"2020-05-28","PROGRESO","0","1","0","1"
"2020-05-28","PUEBLO ANDINO","2","5","1","8"
"2020-05-28","PUEBLO ESTHER","0","25","0","25"
"2020-05-28","PUEBLO IRIGOYEN","0","1","0","1"
"2020-05-28","PUEBLO URANGA","0","1","0","1"
"2020-05-28","PUERTO ARAGON","0","1","0","1"
"2020-05-28","PUERTO GENERAL SAN MARTIN","0","34","0","34"
"2020-05-28","PUERTO RECONQUISTA","0","1","0","1"
"2020-05-28","PUJATO","2","8","0","10"
"2020-05-28","RAFAELA","21","166","27","214"
"2020-05-28","RAMONA","0","2","0","2"
"2020-05-28","RECONQUISTA","0","57","4","61"
"2020-05-28","RECREO","0","25","0","25"
"2020-05-28","RICARDONE","0","9","0","9"
"2020-05-28","RINCON POTRERO","0","1","0","1"
"2020-05-28","ROLDAN","6","56","0","62"
"2020-05-28","ROMANG","0","3","0","3"
"2020-05-28","ROSARIO","113","4607","76","4796"
"2020-05-28","RUFINO","0","33","0","33"
"2020-05-28","SALTO GRANDE","0","2","0","2"
"2020-05-28","SAN ANTONIO DE OBLIGADO","0","1","0","1"
"2020-05-28","SAN CARLOS CENTRO","0","14","0","14"
"2020-05-28","SAN CARLOS SUD","1","2","0","3"
"2020-05-28","SAN CRISTOBAL","0","6","0","6"
"2020-05-28","SANCTI SPIRITU","1","26","0","27"
"2020-05-28","SAN EDUARDO","0","8","0","8"
"2020-05-28","SAN FABIAN","0","1","0","1"
"2020-05-28","SANFORD","0","3","0","3"
"2020-05-28","SAN FRANCISCO DE SANTA FE","0","2","0","2"
"2020-05-28","SAN GENARO","1","5","0","6"
"2020-05-28","SAN GREGORIO","0","5","0","5"
"2020-05-28","SAN GUILLERMO","0","4","0","4"
"2020-05-28","SAN JAVIER","1","12","1","14"
"2020-05-28","SAN JERONIMO DEL SAUCE","0","1","0","1"
"2020-05-28","SAN JERONIMO NORTE","0","3","0","3"
"2020-05-28","SAN JERONIMO SUD","0","4","0","4"
"2020-05-28","SAN JORGE","0","13","4","17"
"2020-05-28","SAN JOSE DE LA ESQUINA","0","10","3","13"
"2020-05-28","SAN JOSE DEL RINCON","1","13","2","16"
"2020-05-28","SAN JUSTO","0","15","0","15"
"2020-05-28","SAN LORENZO","3","121","6","130"
"2020-05-28","SAN MARTIN DE LAS ESCOBAS","0","3","0","3"
"2020-05-28","SAN MARTIN NORTE","0","1","0","1"
"2020-05-28","SANTA CLARA DE BUENA VISTA","0","2","0","2"
"2020-05-28","SANTA FE","27","778","55","860"
"2020-05-28","SANTA ISABEL","0","8","1","9"
"2020-05-28","SANTA ROSA DE CALCHINES","0","5","1","6"
"2020-05-28","SANTO DOMINGO","0","2","0","2"
"2020-05-28","SANTO TOME","5","108","2","115"
"2020-05-28","SAN VICENTE","0","3","0","3"
"2020-05-28","SA PEREYRA","0","2","0","2"
"2020-05-28","SARGENTO CABRAL","0","2","0","2"
"2020-05-28","SARMIENTO","0","2","0","2"
"2020-05-28","SASTRE","0","4","0","4"
"2020-05-28","SAUCE VIEJO","1","21","0","22"
"2020-05-28","SERODINO","0","3","0","3"
"2020-05-28","SOLDINI","0","5","0","5"
"2020-05-28","SUARDI","0","4","0","4"
"2020-05-28","SUNCHALES","0","9","1","10"
"2020-05-28","SUSANA","0","1","0","1"
"2020-05-28","TACURAL","0","3","0","3"
"2020-05-28","TEODELINA","0","8","0","8"
"2020-05-28","TIMBUES","0","13","1","14"
"2020-05-28","TOSTADO","0","6","0","6"
"2020-05-28","TOTORAS","0","6","0","6"
"2020-05-28","VENADO TUERTO","12","240","6","258"
"2020-05-28","VERA","1","24","2","27"
"2020-05-28","VIDELA","0","1","0","1"
"2020-05-28","VILLA AMELIA","0","1","0","1"
"2020-05-28","VILLA ANA","0","3","0","3"
"2020-05-28","VILLA CAÑAS","0","5","0","5"
"2020-05-28","VILLA CONSTITUCION","9","50","2","61"
"2020-05-28","VILLADA","0","1","0","1"
"2020-05-28","VILLA ELOISA","0","2","0","2"
"2020-05-28","VILLA GOBERNADOR GALVEZ","2","222","4","228"
"2020-05-28","VILLA MINETTI","0","5","0","5"
"2020-05-28","VILLA MUGUETA","0","5","1","6"
"2020-05-28","VILLA OCAMPO","0","6","1","7"
"2020-05-28","VILLA TRINIDAD","0","2","0","2"
"2020-05-28","WHEELWRIGHT","0","9","1","10"
"2020-05-28","ZAVALLA","0","4","0","4"
"2020-05-29","ACEBAL","0","5","0","5"
"2020-05-29","ALBARELLOS","0","1","0","1"
"2020-05-29","ALCORTA","0","7","0","7"
"2020-05-29","ALDAO","0","1","0","1"
"2020-05-29","ALVAREZ","0","8","0","8"
"2020-05-29","ALVEAR","0","12","0","12"
"2020-05-29","AMENABAR","0","1","0","1"
"2020-05-29","ANGEL GALLARDO","0","6","0","6"
"2020-05-29","ANGELICA","0","1","0","1"
"2020-05-29","AREQUITO","0","4","0","4"
"2020-05-29","ARMINDA","0","0","1","1"
"2020-05-29","ARMSTRONG","2","17","0","19"
"2020-05-29","AROCENA","0","5","0","5"
"2020-05-29","ARROYO AGUIAR","0","1","0","1"
"2020-05-29","ARROYO LEYES","0","11","1","12"
"2020-05-29","ARROYO SECO","2","43","2","47"
"2020-05-29","ARRUFO","0","2","0","2"
"2020-05-29","ARTEAGA","0","4","0","4"
"2020-05-29","AVELLANEDA","0","19","0","19"
"2020-05-29","BARRANCAS","0","3","0","3"
"2020-05-29","BAUER Y SIGEL","0","0","1","1"
"2020-05-29","BERAVEBU","0","1","0","1"
"2020-05-29","BERNA","0","1","0","1"
"2020-05-29","BERNARDO DE IRIGOYEN","0","2","0","2"
"2020-05-29","BIGAND","0","18","1","19"
"2020-05-29","BOMBAL","0","7","0","7"
"2020-05-29","BOUQUET","0","1","0","1"
"2020-05-29","BUSTINZA","0","1","0","1"
"2020-05-29","CAFFERATA","0","2","0","2"
"2020-05-29","CALCHAQUI","0","10","0","10"
"2020-05-29","CAÑADA DE GOMEZ","1","50","0","51"
"2020-05-29","CAÑADA DEL UCLE","0","1","0","1"
"2020-05-29","CAPITAN BERMUDEZ","1","64","1","66"
"2020-05-29","CARCARAÑA","0","20","0","20"
"2020-05-29","CARLOS PELLEGRINI","0","9","0","9"
"2020-05-29","CARMEN","0","4","0","4"
"2020-05-29","CARRERAS","0","5","0","5"
"2020-05-29","CARRIZALES","0","3","0","3"
"2020-05-29","CASAS","0","1","0","1"
"2020-05-29","CASILDA","2","62","1","65"
"2020-05-29","CAYASTA","1","4","0","5"
"2020-05-29","CENTENO","0","1","0","1"
"2020-05-29","CERES","0","19","0","19"
"2020-05-29","CHABAS","1","13","0","14"
"2020-05-29","CHAÑAR LADEADO","0","3","0","3"
"2020-05-29","CHOVET","0","10","0","10"
"2020-05-29","CHRISTOPHERSEN","0","2","0","2"
"2020-05-29","CLASON","0","1","0","1"
"2020-05-29","COLONIA MASCIAS","0","1","0","1"
"2020-05-29","COLONIA ROSA","0","1","0","1"
"2020-05-29","CORONDA","0","13","0","13"
"2020-05-29","CORONEL ARNOLD","0","2","0","2"
"2020-05-29","CORONEL BOGADO","0","2","0","2"
"2020-05-29","CORONEL RODOLFO S. DOMINGUEZ","0","2","0","2"
"2020-05-29","CORREA","0","7","1","8"
"2020-05-29","CULULU","0","1","0","1"
"2020-05-29","DESVIO ARIJON","0","3","0","3"
"2020-05-29","DIAZ","0","1","0","1"
"2020-05-29","DIEGO DE ALVEAR","0","4","0","4"
"2020-05-29","EL ARAZA","0","1","0","1"
"2020-05-29","ELISA","0","1","0","1"
"2020-05-29","ELORTONDO","4","11","0","15"
"2020-05-29","EL RABON","0","2","0","2"
"2020-05-29","EL TREBOL","0","9","1","10"
"2020-05-29","EMPALME VILLA CONSTITUCION","0","9","0","9"
"2020-05-29","ESPERANZA","1","54","4","59"
"2020-05-29","FELICIA","0","0","1","1"
"2020-05-29","FIGHIERA","0","5","0","5"
"2020-05-29","FIRMAT","1","35","0","36"
"2020-05-29","FLORENCIA","0","3","0","3"
"2020-05-29","FORTIN OLMOS","0","3","0","3"
"2020-05-29","FRANCK","1","9","0","10"
"2020-05-29","FRAY LUIS BELTRAN","4","40","0","44"
"2020-05-29","FRONTERA","0","27","3","30"
"2020-05-29","FUENTES","0","4","0","4"
"2020-05-29","FUNES","5","79","1","85"
"2020-05-29","GABOTO","0","3","1","4"
"2020-05-29","GALVEZ","9","21","1","31"
"2020-05-29","GATO COLORADO","0","1","0","1"
"2020-05-29","GENERAL LAGOS","0","5","0","5"
"2020-05-29","GESSLER","0","1","0","1"
"2020-05-29","GOBERNADOR CRESPO","0","4","0","4"
"2020-05-29","GODEKEN","0","4","1","5"
"2020-05-29","GODOY","0","1","0","1"
"2020-05-29","GRANADERO BAIGORRIA","2","126","1","129"
"2020-05-29","GREGORIA PEREZ DE DENIS","0","1","0","1"
"2020-05-29","GRUTLY","0","0","1","1"
"2020-05-29","HELVECIA","2","18","1","21"
"2020-05-29","HUGHES","0","8","0","8"
"2020-05-29","HUMBERTO PRIMO","0","1","0","1"
"2020-05-29","HUMBOLDT","1","2","0","3"
"2020-05-29","IBARLUCEA","0","11","0","11"
"2020-05-29","JOSEFINA","0","3","0","3"
"2020-05-29","JUAN B. MOLINA","0","1","0","1"
"2020-05-29","JUNCAL","0","2","0","2"
"2020-05-29","LABORDEBOY","0","2","0","2"
"2020-05-29","LA BRAVA","0","1","0","1"
"2020-05-29","LA CAROLINA","0","1","0","1"
"2020-05-29","LA CRIOLLA","0","3","0","3"
"2020-05-29","LAGUNA PAIVA","0","8","0","8"
"2020-05-29","LANDETA","0","2","0","2"
"2020-05-29","LANTERI","0","1","0","1"
"2020-05-29","LAS PAREJAS","1","21","0","22"
"2020-05-29","LAS ROSAS","2","20","0","22"
"2020-05-29","LAS TOSCAS","0","4","0","4"
"2020-05-29","LA VANGUARDIA","0","1","0","1"
"2020-05-29","LEHMANN","0","3","0","3"
"2020-05-29","LLAMBI CAMPBELL","3","3","0","6"
"2020-05-29","LOPEZ","0","2","0","2"
"2020-05-29","LOS MOLINOS","0","1","0","1"
"2020-05-29","LOS QUIRQUINCHOS","0","3","0","3"
"2020-05-29","LUIS PALACIOS","0","4","0","4"
"2020-05-29","MACIEL","0","8","1","9"
"2020-05-29","MAGGIOLO","0","4","0","4"
"2020-05-29","MALABRIGO","0","1","0","1"
"2020-05-29","MARGARITA","0","3","0","3"
"2020-05-29","MARIA JUANA","1","8","0","9"
"2020-05-29","MARIA SUSANA","0","4","0","4"
"2020-05-29","MARIA TERESA","0","2","0","2"
"2020-05-29","MAXIMO PAZ","0","3","0","3"
"2020-05-29","MELINCUE","0","1","0","1"
"2020-05-29","MIGUEL TORRES","0","3","0","3"
"2020-05-29","MONJE","0","2","0","2"
"2020-05-29","MONTEFIORE","0","1","0","1"
"2020-05-29","MONTES DE OCA","0","4","0","4"
"2020-05-29","MONTE VERA","0","13","0","13"
"2020-05-29","MOUSSY","0","1","0","1"
"2020-05-29","MURPHY","0","8","0","8"
"2020-05-29","NELSON","0","4","0","4"
"2020-05-29","NUEVO TORINO","0","1","0","1"
"2020-05-29","OLIVEROS","4","23","1","28"
"2020-05-29","PAVON","0","2","0","2"
"2020-05-29","PAVON ARRIBA","0","1","0","1"
"2020-05-29","PEREZ","0","67","2","69"
"2020-05-29","PIAMONTE","0","2","0","2"
"2020-05-29","PILAR","0","6","0","6"
"2020-05-29","PIÑERO","0","2","0","2"
"2020-05-29","PLAZA CLUCELLAS","0","5","0","5"
"2020-05-29","PRESIDENTE ROCA","0","1","0","1"
"2020-05-29","PROGRESO","0","1","0","1"
"2020-05-29","PUEBLO ANDINO","2","6","0","8"
"2020-05-29","PUEBLO ESTHER","0","25","0","25"
"2020-05-29","PUEBLO IRIGOYEN","0","1","0","1"
"2020-05-29","PUEBLO URANGA","0","1","0","1"
"2020-05-29","PUERTO ARAGON","0","1","0","1"
"2020-05-29","PUERTO GENERAL SAN MARTIN","0","35","0","35"
"2020-05-29","PUERTO RECONQUISTA","0","1","0","1"
"2020-05-29","PUJATO","2","8","0","10"
"2020-05-29","RAFAELA","21","170","27","218"
"2020-05-29","RAMONA","0","2","1","3"
"2020-05-29","RECONQUISTA","0","59","3","62"
"2020-05-29","RECREO","0","25","0","25"
"2020-05-29","RICARDONE","0","9","0","9"
"2020-05-29","RINCON POTRERO","0","1","0","1"
"2020-05-29","ROLDAN","6","57","0","63"
"2020-05-29","ROMANG","0","3","0","3"
"2020-05-29","ROSARIO","113","4724","57","4894"
"2020-05-29","RUFINO","0","34","0","34"
"2020-05-29","SALTO GRANDE","0","2","0","2"
"2020-05-29","SAN ANTONIO DE OBLIGADO","0","1","0","1"
"2020-05-29","SAN CARLOS CENTRO","0","14","0","14"
"2020-05-29","SAN CARLOS SUD","1","2","0","3"
"2020-05-29","SAN CRISTOBAL","0","6","0","6"
"2020-05-29","SANCTI SPIRITU","1","26","0","27"
"2020-05-29","SAN EDUARDO","0","8","0","8"
"2020-05-29","SAN FABIAN","0","1","0","1"
"2020-05-29","SANFORD","0","3","0","3"
"2020-05-29","SAN FRANCISCO DE SANTA FE","0","2","0","2"
"2020-05-29","SAN GENARO","1","5","0","6"
"2020-05-29","SAN GREGORIO","0","5","0","5"
"2020-05-29","SAN GUILLERMO","0","4","0","4"
"2020-05-29","SAN JAVIER","1","13","0","14"
"2020-05-29","SAN JERONIMO DEL SAUCE","0","1","0","1"
"2020-05-29","SAN JERONIMO NORTE","0","3","0","3"
"2020-05-29","SAN JERONIMO SUD","0","4","0","4"
"2020-05-29","SAN JORGE","0","16","1","17"
"2020-05-29","SAN JOSE DE LA ESQUINA","0","10","3","13"
"2020-05-29","SAN JOSE DEL RINCON","1","13","2","16"
"2020-05-29","SAN JUSTO","0","15","0","15"
"2020-05-29","SAN LORENZO","3","125","5","133"
"2020-05-29","SAN MARTIN DE LAS ESCOBAS","0","3","0","3"
"2020-05-29","SAN MARTIN NORTE","0","1","0","1"
"2020-05-29","SANTA CLARA DE BUENA VISTA","0","2","0","2"
"2020-05-29","SANTA FE","27","797","46","870"
"2020-05-29","SANTA ISABEL","0","9","1","10"
"2020-05-29","SANTA ROSA DE CALCHINES","0","6","0","6"
"2020-05-29","SANTO DOMINGO","0","2","0","2"
"2020-05-29","SANTO TOME","5","109","1","115"
"2020-05-29","SAN VICENTE","0","3","0","3"
"2020-05-29","SA PEREYRA","0","2","0","2"
"2020-05-29","SARGENTO CABRAL","0","2","0","2"
"2020-05-29","SARMIENTO","0","2","0","2"
"2020-05-29","SASTRE","0","4","0","4"
"2020-05-29","SAUCE VIEJO","1","21","1","23"
"2020-05-29","SERODINO","0","3","0","3"
"2020-05-29","SOLDINI","0","5","0","5"
"2020-05-29","SUARDI","0","4","0","4"
"2020-05-29","SUNCHALES","0","10","0","10"
"2020-05-29","SUSANA","0","1","0","1"
"2020-05-29","TACURAL","0","3","0","3"
"2020-05-29","TEODELINA","0","10","0","10"
"2020-05-29","TIMBUES","0","13","1","14"
"2020-05-29","TOSTADO","0","6","0","6"
"2020-05-29","TOTORAS","0","6","1","7"
"2020-05-29","VENADO TUERTO","12","264","6","282"
"2020-05-29","VERA","1","26","0","27"
"2020-05-29","VIDELA","0","1","0","1"
"2020-05-29","VILLA AMELIA","0","1","0","1"
"2020-05-29","VILLA ANA","0","3","0","3"
"2020-05-29","VILLA CAÑAS","0","5","0","5"
"2020-05-29","VILLA CONSTITUCION","9","54","1","64"
"2020-05-29","VILLADA","0","1","0","1"
"2020-05-29","VILLA ELOISA","0","2","0","2"
"2020-05-29","VILLA GOBERNADOR GALVEZ","2","226","5","233"
"2020-05-29","VILLA GUILLERMINA","0","0","2","2"
"2020-05-29","VILLA MINETTI","0","5","0","5"
"2020-05-29","VILLA MUGUETA","0","6","0","6"
"2020-05-29","VILLA OCAMPO","0","6","1","7"
"2020-05-29","VILLA TRINIDAD","0","2","0","2"
"2020-05-29","WHEELWRIGHT","0","9","1","10"
"2020-05-29","ZAVALLA","0","4","0","4"
"2020-05-30","ACEBAL","0","5","2","7"
"2020-05-30","ALBARELLOS","0","1","0","1"
"2020-05-30","ALCORTA","0","7","0","7"
"2020-05-30","ALDAO","0","1","0","1"
"2020-05-30","ALVAREZ","0","8","0","8"
"2020-05-30","ALVEAR","0","12","0","12"
"2020-05-30","AMENABAR","0","1","0","1"
"2020-05-30","ANGEL GALLARDO","0","6","0","6"
"2020-05-30","ANGELICA","0","1","0","1"
"2020-05-30","AREQUITO","0","5","0","5"
"2020-05-30","ARMINDA","0","1","0","1"
"2020-05-30","ARMSTRONG","2","17","0","19"
"2020-05-30","AROCENA","0","5","0","5"
"2020-05-30","ARROYO AGUIAR","0","1","0","1"
"2020-05-30","ARROYO LEYES","0","11","1","12"
"2020-05-30","ARROYO SECO","2","45","0","47"
"2020-05-30","ARRUFO","0","2","0","2"
"2020-05-30","ARTEAGA","0","4","0","4"
"2020-05-30","AVELLANEDA","0","19","0","19"
"2020-05-30","BARRANCAS","0","3","0","3"
"2020-05-30","BAUER Y SIGEL","0","1","0","1"
"2020-05-30","BERAVEBU","0","1","0","1"
"2020-05-30","BERNA","0","1","0","1"
"2020-05-30","BERNARDO DE IRIGOYEN","0","2","0","2"
"2020-05-30","BIGAND","0","19","0","19"
"2020-05-30","BOMBAL","0","7","0","7"
"2020-05-30","BOUQUET","0","1","0","1"
"2020-05-30","BUSTINZA","0","1","0","1"
"2020-05-30","CAFFERATA","0","2","0","2"
"2020-05-30","CALCHAQUI","0","10","0","10"
"2020-05-30","CAÑADA DE GOMEZ","1","51","0","52"
"2020-05-30","CAÑADA DEL UCLE","0","1","0","1"
"2020-05-30","CAPITAN BERMUDEZ","1","64","3","68"
"2020-05-30","CARCARAÑA","0","21","0","21"
"2020-05-30","CARLOS PELLEGRINI","0","9","1","10"
"2020-05-30","CARMEN","0","4","0","4"
"2020-05-30","CARRERAS","0","5","0","5"
"2020-05-30","CARRIZALES","0","3","0","3"
"2020-05-30","CASAS","0","1","0","1"
"2020-05-30","CASILDA","2","62","1","65"
"2020-05-30","CAYASTA","1","4","0","5"
"2020-05-30","CENTENO","0","1","0","1"
"2020-05-30","CERES","0","19","0","19"
"2020-05-30","CHABAS","1","13","0","14"
"2020-05-30","CHAÑAR LADEADO","0","3","0","3"
"2020-05-30","CHOVET","0","10","0","10"
"2020-05-30","CHRISTOPHERSEN","0","2","0","2"
"2020-05-30","CLASON","0","1","0","1"
"2020-05-30","COLONIA MASCIAS","0","1","0","1"
"2020-05-30","COLONIA ROSA","0","1","0","1"
"2020-05-30","CORONDA","0","13","1","14"
"2020-05-30","CORONEL ARNOLD","0","2","0","2"
"2020-05-30","CORONEL BOGADO","0","2","0","2"
"2020-05-30","CORONEL RODOLFO S. DOMINGUEZ","0","2","0","2"
"2020-05-30","CORREA","0","7","1","8"
"2020-05-30","CULULU","0","1","0","1"
"2020-05-30","DESVIO ARIJON","0","3","0","3"
"2020-05-30","DIAZ","0","1","0","1"
"2020-05-30","DIEGO DE ALVEAR","0","4","0","4"
"2020-05-30","EL ARAZA","0","1","0","1"
"2020-05-30","ELISA","0","1","0","1"
"2020-05-30","ELORTONDO","4","11","0","15"
"2020-05-30","EL RABON","0","2","0","2"
"2020-05-30","EL TREBOL","0","10","0","10"
"2020-05-30","EMPALME VILLA CONSTITUCION","0","9","0","9"
"2020-05-30","ESPERANZA","1","57","2","60"
"2020-05-30","FELICIA","0","1","1","2"
"2020-05-30","FIGHIERA","0","5","0","5"
"2020-05-30","FIRMAT","1","35","0","36"
"2020-05-30","FLORENCIA","0","3","0","3"
"2020-05-30","FORTIN OLMOS","0","3","0","3"
"2020-05-30","FRANCK","1","9","1","11"
"2020-05-30","FRAY LUIS BELTRAN","4","40","1","45"
"2020-05-30","FRONTERA","0","30","0","30"
"2020-05-30","FUENTES","0","4","0","4"
"2020-05-30","FUNES","5","80","1","86"
"2020-05-30","GABOTO","0","3","1","4"
"2020-05-30","GALVEZ","9","21","1","31"
"2020-05-30","GATO COLORADO","0","1","0","1"
"2020-05-30","GENERAL LAGOS","0","5","0","5"
"2020-05-30","GESSLER","0","1","0","1"
"2020-05-30","GOBERNADOR CRESPO","0","4","0","4"
"2020-05-30","GODEKEN","0","5","0","5"
"2020-05-30","GODOY","0","1","0","1"
"2020-05-30","GRANADERO BAIGORRIA","2","127","0","129"
"2020-05-30","GREGORIA PEREZ DE DENIS","0","1","0","1"
"2020-05-30","GRUTLY","0","1","0","1"
"2020-05-30","HELVECIA","2","18","1","21"
"2020-05-30","HUGHES","0","8","0","8"
"2020-05-30","HUMBERTO PRIMO","0","1","0","1"
"2020-05-30","HUMBOLDT","1","2","0","3"
"2020-05-30","IBARLUCEA","0","11","0","11"
"2020-05-30","JOSEFINA","0","3","0","3"
"2020-05-30","JUAN B. MOLINA","0","1","0","1"
"2020-05-30","JUNCAL","0","2","0","2"
"2020-05-30","LABORDEBOY","0","2","0","2"
"2020-05-30","LA BRAVA","0","1","0","1"
"2020-05-30","LA CAROLINA","0","1","0","1"
"2020-05-30","LA CRIOLLA","0","3","0","3"
"2020-05-30","LAGUNA PAIVA","0","8","0","8"
"2020-05-30","LANDETA","0","2","0","2"
"2020-05-30","LANTERI","0","1","0","1"
"2020-05-30","LAS PAREJAS","1","22","0","23"
"2020-05-30","LAS ROSAS","2","20","1","23"
"2020-05-30","LAS TOSCAS","0","4","0","4"
"2020-05-30","LA VANGUARDIA","0","1","0","1"
"2020-05-30","LEHMANN","0","3","0","3"
"2020-05-30","LLAMBI CAMPBELL","3","3","0","6"
"2020-05-30","LOPEZ","0","2","0","2"
"2020-05-30","LOS MOLINOS","0","1","0","1"
"2020-05-30","LOS QUIRQUINCHOS","0","3","0","3"
"2020-05-30","LUIS PALACIOS","0","4","0","4"
"2020-05-30","MACIEL","0","8","1","9"
"2020-05-30","MAGGIOLO","0","4","0","4"
"2020-05-30","MALABRIGO","0","1","0","1"
"2020-05-30","MARGARITA","0","3","0","3"
"2020-05-30","MARIA JUANA","1","8","0","9"
"2020-05-30","MARIA SUSANA","0","4","0","4"
"2020-05-30","MARIA TERESA","0","2","0","2"
"2020-05-30","MAXIMO PAZ","0","4","0","4"
"2020-05-30","MELINCUE","0","1","0","1"
"2020-05-30","MIGUEL TORRES","0","3","0","3"
"2020-05-30","MONJE","0","2","0","2"
"2020-05-30","MONTEFIORE","0","1","0","1"
"2020-05-30","MONTES DE OCA","0","4","0","4"
"2020-05-30","MONTE VERA","0","13","0","13"
"2020-05-30","MOUSSY","0","1","0","1"
"2020-05-30","MURPHY","0","8","0","8"
"2020-05-30","NELSON","0","4","1","5"
"2020-05-30","NUEVO TORINO","0","1","0","1"
"2020-05-30","OLIVEROS","4","23","1","28"
"2020-05-30","PAVON","0","2","0","2"
"2020-05-30","PAVON ARRIBA","0","1","0","1"
"2020-05-30","PEREZ","0","68","2","70"
"2020-05-30","PIAMONTE","0","2","0","2"
"2020-05-30","PILAR","0","6","0","6"
"2020-05-30","PIÑERO","0","2","0","2"
"2020-05-30","PLAZA CLUCELLAS","0","5","0","5"
"2020-05-30","PRESIDENTE ROCA","0","1","0","1"
"2020-05-30","PROGRESO","0","1","0","1"
"2020-05-30","PUEBLO ANDINO","2","6","0","8"
"2020-05-30","PUEBLO ESTHER","0","25","0","25"
"2020-05-30","PUEBLO IRIGOYEN","0","1","0","1"
"2020-05-30","PUEBLO URANGA","0","1","0","1"
"2020-05-30","PUERTO ARAGON","0","1","0","1"
"2020-05-30","PUERTO GENERAL SAN MARTIN","0","35","2","37"
"2020-05-30","PUERTO RECONQUISTA","0","1","0","1"
"2020-05-30","PUJATO","2","8","0","10"
"2020-05-30","RAFAELA","21","191","7","219"
"2020-05-30","RAMONA","0","3","0","3"
"2020-05-30","RECONQUISTA","0","61","1","62"
"2020-05-30","RECREO","0","25","0","25"
"2020-05-30","RICARDONE","0","9","0","9"
"2020-05-30","RINCON POTRERO","0","1","0","1"
"2020-05-30","ROLDAN","6","57","1","64"
"2020-05-30","ROMANG","0","3","0","3"
"2020-05-30","ROSARIO","113","4809","91","5013"
"2020-05-30","RUFINO","0","34","1","35"
"2020-05-30","SALTO GRANDE","0","2","0","2"
"2020-05-30","SAN ANTONIO DE OBLIGADO","0","1","0","1"
"2020-05-30","SAN CARLOS CENTRO","0","14","0","14"
"2020-05-30","SAN CARLOS SUD","1","2","0","3"
"2020-05-30","SAN CRISTOBAL","0","6","0","6"
"2020-05-30","SANCTI SPIRITU","1","26","0","27"
"2020-05-30","SAN EDUARDO","0","8","0","8"
"2020-05-30","SAN FABIAN","0","1","0","1"
"2020-05-30","SANFORD","0","3","0","3"
"2020-05-30","SAN FRANCISCO DE SANTA FE","0","2","0","2"
"2020-05-30","SAN GENARO","1","5","0","6"
"2020-05-30","SAN GREGORIO","0","5","0","5"
"2020-05-30","SAN GUILLERMO","0","4","0","4"
"2020-05-30","SAN JAVIER","1","13","0","14"
"2020-05-30","SAN JERONIMO DEL SAUCE","0","1","0","1"
"2020-05-30","SAN JERONIMO NORTE","0","3","0","3"
"2020-05-30","SAN JERONIMO SUD","0","4","0","4"
"2020-05-30","SAN JORGE","0","16","1","17"
"2020-05-30","SAN JOSE DE LA ESQUINA","0","10","3","13"
"2020-05-30","SAN JOSE DEL RINCON","1","14","1","16"
"2020-05-30","SAN JUSTO","0","15","0","15"
"2020-05-30","SAN LORENZO","4","126","4","134"
"2020-05-30","SAN MARTIN DE LAS ESCOBAS","0","3","0","3"
"2020-05-30","SAN MARTIN NORTE","0","1","0","1"
"2020-05-30","SANTA CLARA DE BUENA VISTA","0","2","0","2"
"2020-05-30","SANTA FE","27","817","26","870"
"2020-05-30","SANTA ISABEL","0","9","1","10"
"2020-05-30","SANTA ROSA DE CALCHINES","0","6","0","6"
"2020-05-30","SANTO DOMINGO","0","2","0","2"
"2020-05-30","SANTO TOME","5","110","0","115"
"2020-05-30","SAN VICENTE","0","3","0","3"
"2020-05-30","SA PEREYRA","0","2","0","2"
"2020-05-30","SARGENTO CABRAL","0","2","0","2"
"2020-05-30","SARMIENTO","0","2","0","2"
"2020-05-30","SASTRE","0","4","0","4"
"2020-05-30","SAUCE VIEJO","1","21","1","23"
"2020-05-30","SERODINO","0","3","0","3"
"2020-05-30","SOLDINI","0","5","0","5"
"2020-05-30","SUARDI","0","4","0","4"
"2020-05-30","SUNCHALES","0","10","0","10"
"2020-05-30","SUSANA","0","1","0","1"
"2020-05-30","TACURAL","0","3","0","3"
"2020-05-30","TEODELINA","0","10","0","10"
"2020-05-30","TIMBUES","0","18","1","19"
"2020-05-30","TOSTADO","0","6","0","6"
"2020-05-30","TOTORAS","0","6","1","7"
"2020-05-30","VENADO TUERTO","12","265","6","283"
"2020-05-30","VERA","1","26","0","27"
"2020-05-30","VIDELA","0","1","0","1"
"2020-05-30","VILLA AMELIA","0","1","0","1"
"2020-05-30","VILLA ANA","0","3","0","3"
"2020-05-30","VILLA CAÑAS","0","5","0","5"
"2020-05-30","VILLA CONSTITUCION","9","55","1","65"
"2020-05-30","VILLADA","0","1","0","1"
"2020-05-30","VILLA ELOISA","0","2","0","2"
"2020-05-30","VILLA GOBERNADOR GALVEZ","2","230","5","237"
"2020-05-30","VILLA GUILLERMINA","0","1","1","2"
"2020-05-30","VILLA MINETTI","0","5","0","5"
"2020-05-30","VILLA MUGUETA","0","6","0","6"
"2020-05-30","VILLA OCAMPO","1","6","0","7"
"2020-05-30","VILLA TRINIDAD","0","2","0","2"
"2020-05-30","WHEELWRIGHT","0","9","1","10"
"2020-05-30","ZAVALLA","0","4","0","4"
"2020-05-31","ACEBAL","0","7","0","7"
"2020-05-31","ALBARELLOS","0","1","0","1"
"2020-05-31","ALCORTA","0","7","0","7"
"2020-05-31","ALDAO","0","1","0","1"
"2020-05-31","ALVAREZ","0","8","0","8"
"2020-05-31","ALVEAR","0","12","0","12"
"2020-05-31","AMENABAR","0","1","0","1"
"2020-05-31","ANGEL GALLARDO","0","6","0","6"
"2020-05-31","ANGELICA","0","1","0","1"
"2020-05-31","AREQUITO","0","5","0","5"
"2020-05-31","ARMINDA","0","1","0","1"
"2020-05-31","ARMSTRONG","2","17","0","19"
"2020-05-31","AROCENA","0","5","0","5"
"2020-05-31","ARROYO AGUIAR","0","1","0","1"
"2020-05-31","ARROYO LEYES","0","12","0","12"
"2020-05-31","ARROYO SECO","2","45","1","48"
"2020-05-31","ARRUFO","0","2","0","2"
"2020-05-31","ARTEAGA","0","4","0","4"
"2020-05-31","AVELLANEDA","0","19","0","19"
"2020-05-31","BARRANCAS","0","3","0","3"
"2020-05-31","BAUER Y SIGEL","0","1","0","1"
"2020-05-31","BERAVEBU","0","1","0","1"
"2020-05-31","BERNA","0","1","0","1"
"2020-05-31","BERNARDO DE IRIGOYEN","0","2","0","2"
"2020-05-31","BIGAND","0","19","0","19"
"2020-05-31","BOMBAL","0","7","0","7"
"2020-05-31","BOUQUET","0","1","0","1"
"2020-05-31","BUSTINZA","0","1","0","1"
"2020-05-31","CAFFERATA","0","2","0","2"
"2020-05-31","CALCHAQUI","0","10","0","10"
"2020-05-31","CAÑADA DE GOMEZ","1","51","0","52"
"2020-05-31","CAÑADA DEL UCLE","0","1","0","1"
"2020-05-31","CAPITAN BERMUDEZ","1","66","2","69"
"2020-05-31","CARCARAÑA","0","21","0","21"
"2020-05-31","CARLOS PELLEGRINI","0","11","0","11"
"2020-05-31","CARMEN","0","4","0","4"
"2020-05-31","CARRERAS","0","5","0","5"
"2020-05-31","CARRIZALES","0","3","1","4"
"2020-05-31","CASAS","0","1","0","1"
"2020-05-31","CASILDA","2","62","2","66"
"2020-05-31","CAYASTA","1","4","0","5"
"2020-05-31","CENTENO","0","1","0","1"
"2020-05-31","CERES","0","19","0","19"
"2020-05-31","CHABAS","1","13","0","14"
"2020-05-31","CHAÑAR LADEADO","0","3","0","3"
"2020-05-31","CHOVET","0","10","0","10"
"2020-05-31","CHRISTOPHERSEN","0","2","0","2"
"2020-05-31","CLASON","0","1","0","1"
"2020-05-31","COLONIA MASCIAS","0","1","0","1"
"2020-05-31","COLONIA ROSA","0","1","0","1"
"2020-05-31","CORONDA","0","24","2","26"
"2020-05-31","CORONEL ARNOLD","0","2","0","2"
"2020-05-31","CORONEL BOGADO","0","2","0","2"
"2020-05-31","CORONEL RODOLFO S. DOMINGUEZ","0","2","0","2"
"2020-05-31","CORREA","0","8","0","8"
"2020-05-31","CULULU","0","1","0","1"
"2020-05-31","DESVIO ARIJON","0","3","0","3"
"2020-05-31","DIAZ","0","1","0","1"
"2020-05-31","DIEGO DE ALVEAR","0","4","0","4"
"2020-05-31","EL ARAZA","0","1","0","1"
"2020-05-31","ELISA","0","1","0","1"
"2020-05-31","ELORTONDO","4","11","0","15"
"2020-05-31","EL RABON","0","2","0","2"
"2020-05-31","EL TREBOL","0","10","0","10"
"2020-05-31","EMPALME VILLA CONSTITUCION","0","9","0","9"
"2020-05-31","ESPERANZA","1","59","3","63"
"2020-05-31","FELICIA","0","2","0","2"
"2020-05-31","FIGHIERA","0","5","0","5"
"2020-05-31","FIRMAT","1","35","0","36"
"2020-05-31","FLORENCIA","0","3","0","3"
"2020-05-31","FORTIN OLMOS","0","3","0","3"
"2020-05-31","FRANCK","1","10","0","11"
"2020-05-31","FRAY LUIS BELTRAN","4","41","0","45"
"2020-05-31","FRONTERA","0","31","1","32"
"2020-05-31","FUENTES","0","4","0","4"
"2020-05-31","FUNES","5","80","8","93"
"2020-05-31","GABOTO","0","3","1","4"
"2020-05-31","GALVEZ","9","22","0","31"
"2020-05-31","GATO COLORADO","0","1","0","1"
"2020-05-31","GENERAL LAGOS","0","5","0","5"
"2020-05-31","GESSLER","0","1","0","1"
"2020-05-31","GOBERNADOR CRESPO","0","4","0","4"
"2020-05-31","GODEKEN","0","5","0","5"
"2020-05-31","GODOY","0","1","0","1"
"2020-05-31","GRANADERO BAIGORRIA","2","127","0","129"
"2020-05-31","GREGORIA PEREZ DE DENIS","0","1","0","1"
"2020-05-31","GRUTLY","0","1","0","1"
"2020-05-31","HELVECIA","2","18","1","21"
"2020-05-31","HUGHES","0","8","0","8"
"2020-05-31","HUMBERTO PRIMO","0","1","0","1"
"2020-05-31","HUMBOLDT","1","2","0","3"
"2020-05-31","IBARLUCEA","0","11","0","11"
"2020-05-31","JOSEFINA","0","3","0","3"
"2020-05-31","JUAN B. MOLINA","0","1","0","1"
"2020-05-31","JUNCAL","0","2","0","2"
"2020-05-31","LABORDEBOY","0","2","1","3"
"2020-05-31","LA BRAVA","0","1","0","1"
"2020-05-31","LA CAROLINA","0","1","0","1"
"2020-05-31","LA CRIOLLA","0","3","0","3"
"2020-05-31","LAGUNA PAIVA","0","8","0","8"
"2020-05-31","LANDETA","0","2","0","2"
"2020-05-31","LANTERI","0","1","0","1"
"2020-05-31","LAS PAREJAS","1","22","0","23"
"2020-05-31","LAS ROSAS","2","21","2","25"
"2020-05-31","LAS TOSCAS","0","4","0","4"
"2020-05-31","LA VANGUARDIA","0","1","0","1"
"2020-05-31","LEHMANN","0","3","0","3"
"2020-05-31","LLAMBI CAMPBELL","3","3","0","6"
"2020-05-31","LOPEZ","0","2","0","2"
"2020-05-31","LOS MOLINOS","0","1","0","1"
"2020-05-31","LOS QUIRQUINCHOS","0","3","0","3"
"2020-05-31","LUIS PALACIOS","0","4","0","4"
"2020-05-31","MACIEL","0","8","1","9"
"2020-05-31","MAGGIOLO","0","4","0","4"
"2020-05-31","MALABRIGO","0","1","0","1"
"2020-05-31","MARGARITA","0","3","0","3"
"2020-05-31","MARIA JUANA","1","8","0","9"
"2020-05-31","MARIA SUSANA","0","4","0","4"
"2020-05-31","MARIA TERESA","0","2","0","2"
"2020-05-31","MAXIMO PAZ","0","4","0","4"
"2020-05-31","MELINCUE","0","1","0","1"
"2020-05-31","MIGUEL TORRES","0","3","0","3"
"2020-05-31","MONJE","0","2","0","2"
"2020-05-31","MONTEFIORE","0","1","0","1"
"2020-05-31","MONTES DE OCA","0","4","0","4"
"2020-05-31","MONTE VERA","0","13","0","13"
"2020-05-31","MOUSSY","0","1","0","1"
"2020-05-31","MURPHY","0","8","0","8"
"2020-05-31","NELSON","0","5","0","5"
"2020-05-31","NUEVO TORINO","0","1","0","1"
"2020-05-31","OLIVEROS","4","23","1","28"
"2020-05-31","PAVON","0","2","0","2"
"2020-05-31","PAVON ARRIBA","0","1","0","1"
"2020-05-31","PEREZ","0","68","4","72"
"2020-05-31","PIAMONTE","0","2","0","2"
"2020-05-31","PILAR","0","6","0","6"
"2020-05-31","PIÑERO","0","2","0","2"
"2020-05-31","PLAZA CLUCELLAS","0","5","0","5"
"2020-05-31","PRESIDENTE ROCA","0","1","0","1"
"2020-05-31","PROGRESO","0","1","0","1"
"2020-05-31","PUEBLO ANDINO","2","6","0","8"
"2020-05-31","PUEBLO ESTHER","0","25","0","25"
"2020-05-31","PUEBLO IRIGOYEN","0","1","0","1"
"2020-05-31","PUEBLO URANGA","0","1","0","1"
"2020-05-31","PUERTO ARAGON","0","1","0","1"
"2020-05-31","PUERTO GENERAL SAN MARTIN","0","36","1","37"
"2020-05-31","PUERTO RECONQUISTA","0","1","0","1"
"2020-05-31","PUJATO","2","8","0","10"
"2020-05-31","RAFAELA","21","193","5","219"
"2020-05-31","RAMONA","0","3","0","3"
"2020-05-31","RECONQUISTA","0","61","1","62"
"2020-05-31","RECREO","0","26","0","26"
"2020-05-31","RICARDONE","0","9","1","10"
"2020-05-31","RINCON POTRERO","0","1","0","1"
"2020-05-31","ROLDAN","6","58","0","64"
"2020-05-31","ROMANG","0","3","0","3"
"2020-05-31","ROSARIO","113","4839","126","5078"
"2020-05-31","RUFINO","0","35","0","35"
"2020-05-31","SALTO GRANDE","0","2","0","2"
"2020-05-31","SAN ANTONIO DE OBLIGADO","0","1","0","1"
"2020-05-31","SAN CARLOS CENTRO","0","15","0","15"
"2020-05-31","SAN CARLOS SUD","1","2","0","3"
"2020-05-31","SAN CRISTOBAL","0","6","0","6"
"2020-05-31","SANCTI SPIRITU","1","26","0","27"
"2020-05-31","SAN EDUARDO","0","8","0","8"
"2020-05-31","SAN FABIAN","0","1","0","1"
"2020-05-31","SANFORD","0","3","0","3"
"2020-05-31","SAN FRANCISCO DE SANTA FE","0","2","0","2"
"2020-05-31","SAN GENARO","1","5","0","6"
"2020-05-31","SAN GREGORIO","0","5","0","5"
"2020-05-31","SAN GUILLERMO","0","4","0","4"
"2020-05-31","SAN JAVIER","1","13","0","14"
"2020-05-31","SAN JERONIMO DEL SAUCE","0","1","0","1"
"2020-05-31","SAN JERONIMO NORTE","0","3","0","3"
"2020-05-31","SAN JERONIMO SUD","0","4","1","5"
"2020-05-31","SAN JORGE","0","16","1","17"
"2020-05-31","SAN JOSE DE LA ESQUINA","0","10","3","13"
"2020-05-31","SAN JOSE DEL RINCON","1","15","1","17"
"2020-05-31","SAN JUSTO","0","15","1","16"
"2020-05-31","SAN LORENZO","4","128","5","137"
"2020-05-31","SAN MARTIN DE LAS ESCOBAS","0","3","0","3"
"2020-05-31","SAN MARTIN NORTE","0","1","0","1"
"2020-05-31","SANTA CLARA DE BUENA VISTA","0","2","0","2"
"2020-05-31","SANTA FE","27","832","24","883"
"2020-05-31","SANTA ISABEL","0","9","1","10"
"2020-05-31","SANTA ROSA DE CALCHINES","0","6","0","6"
"2020-05-31","SANTO DOMINGO","0","2","0","2"
"2020-05-31","SANTO TOME","5","113","0","118"
"2020-05-31","SAN VICENTE","0","3","0","3"
"2020-05-31","SA PEREYRA","0","2","0","2"
"2020-05-31","SARGENTO CABRAL","0","2","0","2"
"2020-05-31","SARMIENTO","0","2","0","2"
"2020-05-31","SASTRE","0","4","0","4"
"2020-05-31","SAUCE VIEJO","1","22","0","23"
"2020-05-31","SERODINO","0","3","0","3"
"2020-05-31","SOLDINI","0","5","0","5"
"2020-05-31","SUARDI","0","4","0","4"
"2020-05-31","SUNCHALES","0","10","0","10"
"2020-05-31","SUSANA","0","1","0","1"
"2020-05-31","TACURAL","0","3","0","3"
"2020-05-31","TEODELINA","0","10","0","10"
"2020-05-31","TIMBUES","0","18","1","19"
"2020-05-31","TOSTADO","0","6","0","6"
"2020-05-31","TOTORAS","0","6","1","7"
"2020-05-31","VENADO TUERTO","12","266","5","283"
"2020-05-31","VERA","1","26","0","27"
"2020-05-31","VIDELA","0","1","0","1"
"2020-05-31","VILLA AMELIA","0","1","0","1"
"2020-05-31","VILLA ANA","0","3","0","3"
"2020-05-31","VILLA CAÑAS","0","5","0","5"
"2020-05-31","VILLA CONSTITUCION","9","56","0","65"
"2020-05-31","VILLADA","0","1","0","1"
"2020-05-31","VILLA ELOISA","0","2","0","2"
"2020-05-31","VILLA GOBERNADOR GALVEZ","2","231","6","239"
"2020-05-31","VILLA GUILLERMINA","0","1","1","2"
"2020-05-31","VILLA MINETTI","0","5","0","5"
"2020-05-31","VILLA MUGUETA","0","6","0","6"
"2020-05-31","VILLA OCAMPO","1","6","3","10"
"2020-05-31","VILLA TRINIDAD","0","2","0","2"
"2020-05-31","WHEELWRIGHT","0","9","1","10"
"2020-05-31","ZAVALLA","0","4","0","4"
"2020-06-01","ACEBAL","0","7","0","7"
"2020-06-01","ALBARELLOS","0","1","0","1"
"2020-06-01","ALCORTA","0","7","0","7"
"2020-06-01","ALDAO","0","1","0","1"
"2020-06-01","ALVAREZ","0","9","0","9"
"2020-06-01","ALVEAR","0","12","0","12"
"2020-06-01","AMENABAR","0","1","0","1"
"2020-06-01","ANGEL GALLARDO","0","6","0","6"
"2020-06-01","ANGELICA","0","1","0","1"
"2020-06-01","AREQUITO","0","5","0","5"
"2020-06-01","ARMINDA","0","1","0","1"
"2020-06-01","ARMSTRONG","2","17","0","19"
"2020-06-01","AROCENA","0","5","0","5"
"2020-06-01","ARROYO AGUIAR","0","1","0","1"
"2020-06-01","ARROYO LEYES","0","12","0","12"
"2020-06-01","ARROYO SECO","2","47","0","49"
"2020-06-01","ARRUFO","0","2","0","2"
"2020-06-01","ARTEAGA","0","4","0","4"
"2020-06-01","AVELLANEDA","0","19","1","20"
"2020-06-01","BARRANCAS","0","3","0","3"
"2020-06-01","BAUER Y SIGEL","0","1","0","1"
"2020-06-01","BERAVEBU","0","1","0","1"
"2020-06-01","BERNA","0","1","0","1"
"2020-06-01","BERNARDO DE IRIGOYEN","0","2","0","2"
"2020-06-01","BIGAND","0","19","0","19"
"2020-06-01","BOMBAL","0","7","0","7"
"2020-06-01","BOUQUET","0","1","0","1"
"2020-06-01","BUSTINZA","0","1","0","1"
"2020-06-01","CAFFERATA","0","2","0","2"
"2020-06-01","CALCHAQUI","0","10","0","10"
"2020-06-01","CAÑADA DE GOMEZ","1","51","1","53"
"2020-06-01","CAÑADA DEL UCLE","0","1","0","1"
"2020-06-01","CAPITAN BERMUDEZ","1","68","3","72"
"2020-06-01","CARCARAÑA","0","21","0","21"
"2020-06-01","CARLOS PELLEGRINI","0","11","0","11"
"2020-06-01","CARMEN","0","4","0","4"
"2020-06-01","CARRERAS","0","5","0","5"
"2020-06-01","CARRIZALES","0","3","0","3"
"2020-06-01","CASAS","0","1","0","1"
"2020-06-01","CASILDA","2","63","2","67"
"2020-06-01","CAYASTA","1","4","0","5"
"2020-06-01","CENTENO","0","1","0","1"
"2020-06-01","CERES","0","19","0","19"
"2020-06-01","CHABAS","1","13","0","14"
"2020-06-01","CHAÑAR LADEADO","0","3","0","3"
"2020-06-01","CHOVET","0","10","0","10"
"2020-06-01","CHRISTOPHERSEN","0","2","0","2"
"2020-06-01","CLASON","0","1","0","1"
"2020-06-01","COLONIA MASCIAS","0","1","0","1"
"2020-06-01","COLONIA ROSA","0","1","0","1"
"2020-06-01","CORONDA","0","24","2","26"
"2020-06-01","CORONEL ARNOLD","0","2","0","2"
"2020-06-01","CORONEL BOGADO","0","2","0","2"
"2020-06-01","CORONEL RODOLFO S. DOMINGUEZ","0","2","0","2"
"2020-06-01","CORREA","0","8","0","8"
"2020-06-01","CULULU","0","1","0","1"
"2020-06-01","DESVIO ARIJON","0","3","0","3"
"2020-06-01","DIAZ","0","1","0","1"
"2020-06-01","DIEGO DE ALVEAR","0","4","0","4"
"2020-06-01","EL ARAZA","0","1","0","1"
"2020-06-01","ELISA","0","1","0","1"
"2020-06-01","ELORTONDO","4","11","0","15"
"2020-06-01","EL RABON","0","2","0","2"
"2020-06-01","EL TREBOL","0","10","0","10"
"2020-06-01","EMPALME VILLA CONSTITUCION","0","9","0","9"
"2020-06-01","ESPERANZA","1","59","4","64"
"2020-06-01","FELICIA","0","2","0","2"
"2020-06-01","FIGHIERA","0","5","0","5"
"2020-06-01","FIRMAT","1","35","0","36"
"2020-06-01","FLORENCIA","0","3","0","3"
"2020-06-01","FORTIN OLMOS","0","3","0","3"
"2020-06-01","FRANCK","1","10","0","11"
"2020-06-01","FRAY LUIS BELTRAN","4","42","1","47"
"2020-06-01","FRONTERA","0","31","0","31"
"2020-06-01","FUENTES","0","4","0","4"
"2020-06-01","FUNES","5","88","1","94"
"2020-06-01","GABOTO","0","3","1","4"
"2020-06-01","GALVEZ","9","22","0","31"
"2020-06-01","GATO COLORADO","0","1","0","1"
"2020-06-01","GENERAL LAGOS","0","5","0","5"
"2020-06-01","GESSLER","0","1","0","1"
"2020-06-01","GOBERNADOR CRESPO","0","4","0","4"
"2020-06-01","GODEKEN","0","5","0","5"
"2020-06-01","GODOY","0","1","0","1"
"2020-06-01","GRANADERO BAIGORRIA","2","127","2","131"
"2020-06-01","GREGORIA PEREZ DE DENIS","0","1","0","1"
"2020-06-01","GRUTLY","0","1","0","1"
"2020-06-01","HELVECIA","2","18","1","21"
"2020-06-01","HUGHES","0","8","0","8"
"2020-06-01","HUMBERTO PRIMO","0","1","0","1"
"2020-06-01","HUMBOLDT","1","2","0","3"
"2020-06-01","IBARLUCEA","0","11","0","11"
"2020-06-01","INTIYACO","0","0","1","1"
"2020-06-01","JOSEFINA","0","3","0","3"
"2020-06-01","JUAN B. MOLINA","0","1","0","1"
"2020-06-01","JUNCAL","0","2","0","2"
"2020-06-01","LABORDEBOY","0","3","0","3"
"2020-06-01","LA BRAVA","0","1","0","1"
"2020-06-01","LA CAROLINA","0","1","0","1"
"2020-06-01","LA CRIOLLA","0","3","0","3"
"2020-06-01","LAGUNA PAIVA","0","8","1","9"
"2020-06-01","LANDETA","0","2","0","2"
"2020-06-01","LANTERI","0","1","0","1"
"2020-06-01","LAS PAREJAS","1","22","0","23"
"2020-06-01","LAS ROSAS","2","22","0","24"
"2020-06-01","LAS TOSCAS","0","4","0","4"
"2020-06-01","LA VANGUARDIA","0","1","0","1"
"2020-06-01","LEHMANN","0","3","0","3"
"2020-06-01","LLAMBI CAMPBELL","3","3","0","6"
"2020-06-01","LOPEZ","0","2","0","2"
"2020-06-01","LOS MOLINOS","0","1","0","1"
"2020-06-01","LOS QUIRQUINCHOS","0","3","0","3"
"2020-06-01","LUIS PALACIOS","0","4","0","4"
"2020-06-01","MACIEL","0","8","1","9"
"2020-06-01","MAGGIOLO","0","4","0","4"
"2020-06-01","MALABRIGO","0","1","0","1"
"2020-06-01","MARGARITA","0","3","0","3"
"2020-06-01","MARIA JUANA","1","8","0","9"
"2020-06-01","MARIA SUSANA","0","4","0","4"
"2020-06-01","MARIA TERESA","0","2","0","2"
"2020-06-01","MAXIMO PAZ","0","4","0","4"
"2020-06-01","MELINCUE","0","1","0","1"
"2020-06-01","MIGUEL TORRES","0","3","0","3"
"2020-06-01","MONJE","0","2","0","2"
"2020-06-01","MONTEFIORE","0","1","0","1"
"2020-06-01","MONTES DE OCA","0","4","0","4"
"2020-06-01","MONTE VERA","0","13","0","13"
"2020-06-01","MOUSSY","0","1","0","1"
"2020-06-01","MURPHY","0","8","0","8"
"2020-06-01","NELSON","0","5","0","5"
"2020-06-01","NUEVO TORINO","0","1","0","1"
"2020-06-01","OLIVEROS","4","23","1","28"
"2020-06-01","PAVON","0","2","0","2"
"2020-06-01","PAVON ARRIBA","0","1","0","1"
"2020-06-01","PEREZ","0","70","4","74"
"2020-06-01","PIAMONTE","0","2","0","2"
"2020-06-01","PILAR","0","6","0","6"
"2020-06-01","PIÑERO","0","2","0","2"
"2020-06-01","PLAZA CLUCELLAS","0","5","0","5"
"2020-06-01","PRESIDENTE ROCA","0","1","0","1"
"2020-06-01","PROGRESO","0","1","0","1"
"2020-06-01","PUEBLO ANDINO","2","7","0","9"
"2020-06-01","PUEBLO ESTHER","0","25","0","25"
"2020-06-01","PUEBLO IRIGOYEN","0","1","0","1"
"2020-06-01","PUEBLO URANGA","0","1","0","1"
"2020-06-01","PUERTO ARAGON","0","1","0","1"
"2020-06-01","PUERTO GENERAL SAN MARTIN","0","37","0","37"
"2020-06-01","PUERTO RECONQUISTA","0","1","0","1"
"2020-06-01","PUJATO","2","8","0","10"
"2020-06-01","RAFAELA","21","193","8","222"
"2020-06-01","RAMONA","0","3","0","3"
"2020-06-01","RECONQUISTA","0","61","2","63"
"2020-06-01","RECREO","0","26","1","27"
"2020-06-01","RICARDONE","0","10","0","10"
"2020-06-01","RINCON POTRERO","0","1","0","1"
"2020-06-01","ROLDAN","6","58","2","66"
"2020-06-01","ROMANG","0","3","0","3"
"2020-06-01","ROSARIO","113","4973","70","5156"
"2020-06-01","RUFINO","0","35","0","35"
"2020-06-01","SALTO GRANDE","0","2","0","2"
"2020-06-01","SAN ANTONIO DE OBLIGADO","0","1","0","1"
"2020-06-01","SAN CARLOS CENTRO","0","15","0","15"
"2020-06-01","SAN CARLOS SUD","1","2","0","3"
"2020-06-01","SAN CRISTOBAL","0","6","1","7"
"2020-06-01","SANCTI SPIRITU","1","26","0","27"
"2020-06-01","SAN EDUARDO","0","8","0","8"
"2020-06-01","SAN FABIAN","0","1","0","1"
"2020-06-01","SANFORD","0","3","0","3"
"2020-06-01","SAN FRANCISCO DE SANTA FE","0","2","0","2"
"2020-06-01","SAN GENARO","1","5","0","6"
"2020-06-01","SAN GREGORIO","0","5","0","5"
"2020-06-01","SAN GUILLERMO","0","4","1","5"
"2020-06-01","SAN JAVIER","1","13","1","15"
"2020-06-01","SAN JERONIMO DEL SAUCE","0","1","0","1"
"2020-06-01","SAN JERONIMO NORTE","0","3","0","3"
"2020-06-01","SAN JERONIMO SUD","0","5","0","5"
"2020-06-01","SAN JORGE","0","16","2","18"
"2020-06-01","SAN JOSE DE LA ESQUINA","0","10","3","13"
"2020-06-01","SAN JOSE DEL RINCON","1","15","1","17"
"2020-06-01","SAN JUSTO","0","15","1","16"
"2020-06-01","SAN LORENZO","4","132","5","141"
"2020-06-01","SAN MARTIN DE LAS ESCOBAS","0","3","0","3"
"2020-06-01","SAN MARTIN NORTE","0","1","0","1"
"2020-06-01","SANTA CLARA DE BUENA VISTA","0","2","0","2"
"2020-06-01","SANTA FE","27","835","40","902"
"2020-06-01","SANTA ISABEL","0","9","1","10"
"2020-06-01","SANTA ROSA DE CALCHINES","0","6","0","6"
"2020-06-01","SANTO DOMINGO","0","2","0","2"
"2020-06-01","SANTO TOME","5","113","2","120"
"2020-06-01","SAN VICENTE","0","3","0","3"
"2020-06-01","SA PEREYRA","0","2","0","2"
"2020-06-01","SARGENTO CABRAL","0","2","0","2"
"2020-06-01","SARMIENTO","0","2","0","2"
"2020-06-01","SASTRE","0","4","0","4"
"2020-06-01","SAUCE VIEJO","1","22","1","24"
"2020-06-01","SERODINO","0","3","0","3"
"2020-06-01","SOLDINI","0","5","0","5"
"2020-06-01","SUARDI","0","4","0","4"
"2020-06-01","SUNCHALES","0","10","0","10"
"2020-06-01","SUSANA","0","1","0","1"
"2020-06-01","TACURAL","0","3","0","3"
"2020-06-01","TEODELINA","0","10","0","10"
"2020-06-01","TIMBUES","0","18","1","19"
"2020-06-01","TOSTADO","0","6","0","6"
"2020-06-01","TOTORAS","0","6","1","7"
"2020-06-01","VENADO TUERTO","12","266","7","285"
"2020-06-01","VERA","1","27","1","29"
"2020-06-01","VIDELA","0","1","0","1"
"2020-06-01","VILLA AMELIA","0","1","0","1"
"2020-06-01","VILLA ANA","0","3","0","3"
"2020-06-01","VILLA CAÑAS","0","5","0","5"
"2020-06-01","VILLA CONSTITUCION","9","56","1","66"
"2020-06-01","VILLADA","0","1","1","2"
"2020-06-01","VILLA ELOISA","0","2","0","2"
"2020-06-01","VILLA GOBERNADOR GALVEZ","2","235","3","240"
"2020-06-01","VILLA GUILLERMINA","0","1","1","2"
"2020-06-01","VILLA MINETTI","0","5","0","5"
"2020-06-01","VILLA MUGUETA","0","6","0","6"
"2020-06-01","VILLA OCAMPO","4","6","3","13"
"2020-06-01","VILLA TRINIDAD","0","2","0","2"
"2020-06-01","WHEELWRIGHT","0","9","1","10"
"2020-06-01","ZAVALLA","0","4","0","4"
"2020-06-02","ACEBAL","0","7","1","8"
"2020-06-02","ALBARELLOS","0","1","0","1"
"2020-06-02","ALCORTA","0","7","0","7"
"2020-06-02","ALDAO","0","1","0","1"
"2020-06-02","ALVAREZ","0","9","0","9"
"2020-06-02","ALVEAR","0","12","0","12"
"2020-06-02","AMENABAR","0","1","0","1"
"2020-06-02","ANGEL GALLARDO","0","6","0","6"
"2020-06-02","ANGELICA","0","1","0","1"
"2020-06-02","AREQUITO","0","5","0","5"
"2020-06-02","ARMINDA","0","1","0","1"
"2020-06-02","ARMSTRONG","2","17","0","19"
"2020-06-02","AROCENA","0","5","0","5"
"2020-06-02","ARROYO AGUIAR","0","1","0","1"
"2020-06-02","ARROYO LEYES","0","12","0","12"
"2020-06-02","ARROYO SECO","2","48","1","51"
"2020-06-02","ARRUFO","0","2","0","2"
"2020-06-02","ARTEAGA","0","4","0","4"
"2020-06-02","AVELLANEDA","0","19","1","20"
"2020-06-02","BARRANCAS","0","3","0","3"
"2020-06-02","BAUER Y SIGEL","0","1","0","1"
"2020-06-02","BERAVEBU","0","1","0","1"
"2020-06-02","BERNA","0","1","0","1"
"2020-06-02","BERNARDO DE IRIGOYEN","0","2","0","2"
"2020-06-02","BIGAND","0","19","0","19"
"2020-06-02","BOMBAL","0","7","0","7"
"2020-06-02","BOUQUET","0","1","0","1"
"2020-06-02","BUSTINZA","0","1","0","1"
"2020-06-02","CAFFERATA","0","2","0","2"
"2020-06-02","CALCHAQUI","0","10","0","10"
"2020-06-02","CAÑADA DE GOMEZ","1","52","0","53"
"2020-06-02","CAÑADA DEL UCLE","0","1","0","1"
"2020-06-02","CAPITAN BERMUDEZ","1","70","2","73"
"2020-06-02","CARCARAÑA","0","23","0","23"
"2020-06-02","CARLOS PELLEGRINI","0","11","0","11"
"2020-06-02","CARMEN","0","4","0","4"
"2020-06-02","CARRERAS","0","5","0","5"
"2020-06-02","CARRIZALES","0","3","0","3"
"2020-06-02","CASAS","0","2","0","2"
"2020-06-02","CASILDA","2","67","1","70"
"2020-06-02","CAYASTA","1","4","0","5"
"2020-06-02","CENTENO","0","1","0","1"
"2020-06-02","CERES","0","19","1","20"
"2020-06-02","CHABAS","1","13","0","14"
"2020-06-02","CHAÑAR LADEADO","0","3","0","3"
"2020-06-02","CHOVET","0","10","0","10"
"2020-06-02","CHRISTOPHERSEN","0","2","0","2"
"2020-06-02","CLASON","0","1","0","1"
"2020-06-02","COLONIA MASCIAS","0","1","0","1"
"2020-06-02","COLONIA ROSA","0","1","0","1"
"2020-06-02","CORONDA","0","15","1","16"
"2020-06-02","CORONEL ARNOLD","0","2","0","2"
"2020-06-02","CORONEL BOGADO","0","2","0","2"
"2020-06-02","CORONEL RODOLFO S. DOMINGUEZ","0","2","0","2"
"2020-06-02","CORREA","0","8","0","8"
"2020-06-02","CULULU","0","1","0","1"
"2020-06-02","DESVIO ARIJON","0","3","0","3"
"2020-06-02","DIAZ","0","1","0","1"
"2020-06-02","DIEGO DE ALVEAR","0","4","0","4"
"2020-06-02","EL ARAZA","0","1","0","1"
"2020-06-02","ELISA","0","1","0","1"
"2020-06-02","ELORTONDO","4","11","0","15"
"2020-06-02","EL RABON","0","2","0","2"
"2020-06-02","EL TREBOL","0","10","0","10"
"2020-06-02","EMPALME VILLA CONSTITUCION","0","9","0","9"
"2020-06-02","ESPERANZA","1","63","0","64"
"2020-06-02","FELICIA","0","2","0","2"
"2020-06-02","FIGHIERA","0","4","1","5"
"2020-06-02","FIRMAT","1","35","0","36"
"2020-06-02","FLORENCIA","0","3","1","4"
"2020-06-02","FORTIN OLMOS","0","3","0","3"
"2020-06-02","FRANCK","1","10","0","11"
"2020-06-02","FRAY LUIS BELTRAN","4","43","0","47"
"2020-06-02","FRONTERA","0","31","0","31"
"2020-06-02","FUENTES","0","4","0","4"
"2020-06-02","FUNES","5","88","1","94"
"2020-06-02","GABOTO","0","3","1","4"
"2020-06-02","GALVEZ","9","22","0","31"
"2020-06-02","GATO COLORADO","0","1","0","1"
"2020-06-02","GENERAL LAGOS","0","5","0","5"
"2020-06-02","GESSLER","0","1","0","1"
"2020-06-02","GOBERNADOR CRESPO","0","4","0","4"
"2020-06-02","GODEKEN","0","5","0","5"
"2020-06-02","GODOY","0","1","0","1"
"2020-06-02","GRANADERO BAIGORRIA","2","130","2","134"
"2020-06-02","GREGORIA PEREZ DE DENIS","0","1","0","1"
"2020-06-02","GRUTLY","0","1","0","1"
"2020-06-02","HELVECIA","2","18","1","21"
"2020-06-02","HUGHES","0","8","0","8"
"2020-06-02","HUMBERTO PRIMO","0","1","0","1"
"2020-06-02","HUMBOLDT","1","2","0","3"
"2020-06-02","IBARLUCEA","0","11","0","11"
"2020-06-02","INTIYACO","0","1","0","1"
"2020-06-02","JOSEFINA","0","3","1","4"
"2020-06-02","JUAN B. MOLINA","0","1","0","1"
"2020-06-02","JUNCAL","0","2","0","2"
"2020-06-02","LABORDEBOY","0","3","0","3"
"2020-06-02","LA BRAVA","0","1","0","1"
"2020-06-02","LA CAROLINA","0","1","0","1"
"2020-06-02","LA CRIOLLA","0","3","1","4"
"2020-06-02","LAGUNA PAIVA","0","8","1","9"
"2020-06-02","LANDETA","0","2","0","2"
"2020-06-02","LANTERI","0","1","0","1"
"2020-06-02","LAS PAREJAS","1","22","0","23"
"2020-06-02","LAS ROSAS","2","23","0","25"
"2020-06-02","LAS TOSCAS","0","4","1","5"
"2020-06-02","LA VANGUARDIA","0","1","0","1"
"2020-06-02","LEHMANN","0","3","0","3"
"2020-06-02","LLAMBI CAMPBELL","3","3","0","6"
"2020-06-02","LOPEZ","0","2","0","2"
"2020-06-02","LOS MOLINOS","0","1","0","1"
"2020-06-02","LOS QUIRQUINCHOS","0","3","0","3"
"2020-06-02","LUIS PALACIOS","0","4","0","4"
"2020-06-02","MACIEL","0","8","1","9"
"2020-06-02","MAGGIOLO","0","4","0","4"
"2020-06-02","MALABRIGO","0","1","0","1"
"2020-06-02","MARGARITA","0","3","0","3"
"2020-06-02","MARIA JUANA","1","8","0","9"
"2020-06-02","MARIA SUSANA","0","4","0","4"
"2020-06-02","MARIA TERESA","0","2","0","2"
"2020-06-02","MAXIMO PAZ","0","4","0","4"
"2020-06-02","MELINCUE","0","1","0","1"
"2020-06-02","MIGUEL TORRES","0","3","0","3"
"2020-06-02","MONJE","0","2","0","2"
"2020-06-02","MONTEFIORE","0","1","0","1"
"2020-06-02","MONTES DE OCA","0","4","0","4"
"2020-06-02","MONTE VERA","0","13","0","13"
"2020-06-02","MOUSSY","0","1","0","1"
"2020-06-02","MURPHY","0","8","0","8"
"2020-06-02","NELSON","0","5","1","6"
"2020-06-02","NUEVO TORINO","0","1","0","1"
"2020-06-02","OLIVEROS","4","23","1","28"
"2020-06-02","PAVON","0","2","0","2"
"2020-06-02","PAVON ARRIBA","0","1","0","1"
"2020-06-02","PEREZ","0","74","1","75"
"2020-06-02","PIAMONTE","0","2","0","2"
"2020-06-02","PILAR","0","6","0","6"
"2020-06-02","PIÑERO","0","3","0","3"
"2020-06-02","PLAZA CLUCELLAS","0","5","0","5"
"2020-06-02","PRESIDENTE ROCA","0","1","0","1"
"2020-06-02","PROGRESO","0","1","0","1"
"2020-06-02","PUEBLO ANDINO","2","8","0","10"
"2020-06-02","PUEBLO ESTHER","0","25","0","25"
"2020-06-02","PUEBLO IRIGOYEN","0","1","0","1"
"2020-06-02","PUEBLO URANGA","0","1","0","1"
"2020-06-02","PUERTO ARAGON","0","1","0","1"
"2020-06-02","PUERTO GENERAL SAN MARTIN","0","37","1","38"
"2020-06-02","PUERTO RECONQUISTA","0","1","0","1"
"2020-06-02","PUJATO","2","8","0","10"
"2020-06-02","RAFAELA","21","194","8","223"
"2020-06-02","RAMONA","0","3","0","3"
"2020-06-02","RECONQUISTA","0","61","3","64"
"2020-06-02","RECREO","0","26","1","27"
"2020-06-02","RICARDONE","0","10","0","10"
"2020-06-02","RINCON POTRERO","0","1","0","1"
"2020-06-02","ROLDAN","6","60","0","66"
"2020-06-02","ROMANG","0","3","0","3"
"2020-06-02","ROSARIO","113","5053","72","5238"
"2020-06-02","RUFINO","0","35","0","35"
"2020-06-02","SALTO GRANDE","0","2","0","2"
"2020-06-02","SAN ANTONIO DE OBLIGADO","0","1","0","1"
"2020-06-02","SAN CARLOS CENTRO","0","15","0","15"
"2020-06-02","SAN CARLOS SUD","1","2","0","3"
"2020-06-02","SAN CRISTOBAL","0","6","1","7"
"2020-06-02","SANCTI SPIRITU","1","26","0","27"
"2020-06-02","SAN EDUARDO","0","8","0","8"
"2020-06-02","SAN FABIAN","0","1","0","1"
"2020-06-02","SANFORD","0","3","0","3"
"2020-06-02","SAN FRANCISCO DE SANTA FE","0","2","0","2"
"2020-06-02","SAN GENARO","1","5","0","6"
"2020-06-02","SAN GREGORIO","0","5","0","5"
"2020-06-02","SAN GUILLERMO","0","4","1","5"
"2020-06-02","SAN JAVIER","1","13","0","14"
"2020-06-02","SAN JERONIMO DEL SAUCE","0","1","0","1"
"2020-06-02","SAN JERONIMO NORTE","0","3","0","3"
"2020-06-02","SAN JERONIMO SUD","0","5","0","5"
"2020-06-02","SAN JORGE","0","17","4","21"
"2020-06-02","SAN JOSE DE LA ESQUINA","0","10","3","13"
"2020-06-02","SAN JOSE DEL RINCON","1","15","1","17"
"2020-06-02","SAN JUSTO","0","16","0","16"
"2020-06-02","SAN LORENZO","4","138","7","149"
"2020-06-02","SAN MARTIN DE LAS ESCOBAS","0","3","0","3"
"2020-06-02","SAN MARTIN NORTE","0","1","0","1"
"2020-06-02","SANTA CLARA DE BUENA VISTA","0","2","0","2"
"2020-06-02","SANTA FE","27","855","45","927"
"2020-06-02","SANTA ISABEL","0","9","1","10"
"2020-06-02","SANTA ROSA DE CALCHINES","0","6","0","6"
"2020-06-02","SANTO DOMINGO","0","2","0","2"
"2020-06-02","SANTO TOME","5","115","0","120"
"2020-06-02","SAN VICENTE","0","3","0","3"
"2020-06-02","SA PEREYRA","0","2","0","2"
"2020-06-02","SARGENTO CABRAL","0","2","0","2"
"2020-06-02","SARMIENTO","0","2","0","2"
"2020-06-02","SASTRE","0","4","0","4"
"2020-06-02","SAUCE VIEJO","1","23","0","24"
"2020-06-02","SERODINO","0","3","0","3"
"2020-06-02","SOLDINI","0","5","1","6"
"2020-06-02","SUARDI","0","4","0","4"
"2020-06-02","SUNCHALES","0","10","0","10"
"2020-06-02","SUSANA","0","1","0","1"
"2020-06-02","TACUARENDI","0","0","1","1"
"2020-06-02","TACURAL","0","3","0","3"
"2020-06-02","TEODELINA","0","10","0","10"
"2020-06-02","TIMBUES","0","19","0","19"
"2020-06-02","TOSTADO","0","6","0","6"
"2020-06-02","TOTORAS","0","7","0","7"
"2020-06-02","VENADO TUERTO","12","268","5","285"
"2020-06-02","VERA","1","27","2","30"
"2020-06-02","VIDELA","0","1","0","1"
"2020-06-02","VILLA AMELIA","0","1","0","1"
"2020-06-02","VILLA ANA","0","3","0","3"
"2020-06-02","VILLA CAÑAS","0","5","0","5"
"2020-06-02","VILLA CONSTITUCION","9","58","4","71"
"2020-06-02","VILLADA","0","2","0","2"
"2020-06-02","VILLA ELOISA","0","2","0","2"
"2020-06-02","VILLA GOBERNADOR GALVEZ","2","237","8","247"
"2020-06-02","VILLA GUILLERMINA","0","1","1","2"
"2020-06-02","VILLA LA RIVERA - OLIVEROS","0","1","0","1"
"2020-06-02","VILLA MINETTI","0","5","0","5"
"2020-06-02","VILLA MUGUETA","0","6","0","6"
"2020-06-02","VILLA OCAMPO","4","8","9","21"
"2020-06-02","VILLA TRINIDAD","0","2","0","2"
"2020-06-02","WHEELWRIGHT","0","9","2","11"
"2020-06-02","ZAVALLA","0","4","0","4"
